creative	State1	GROUP_NAME
"HOUSE/AZ07 MCCAIN VOTE RUTH MCCLUNG"	"AZ"	
"HOUSE/CA20 WFA SINCE 2007"	"CA"	"Water for All"
"USSEN/AK AKST ALASKANS STANDING TOGETHER"	"AK"	"ALASKANS STANDING TOGETHER"
"USSEN/AK AKST BIG PROBLEM"	"AK"	"ALASKANS STANDING TOGETHER"
"USSEN/AK AKST BILL SHEFFIELD"	"AK"	"ALASKANS STANDING TOGETHER"
"USSEN/AK AKST BODY GUARDS"	"AK"	"ALASKANS STANDING TOGETHER"
"USSEN/AK AKST MARK HAMILTON"	"AK"	"ALASKANS STANDING TOGETHER"
"USSEN/AK AKST MILLER'S PLAN"	"AK"	"ALASKANS STANDING TOGETHER"
"USSEN/AK AKST NO NEED TO KNOW"	"AK"	"ALASKANS STANDING TOGETHER"
"USSEN/AK AKST REAL JOE MILLER"	"AK"	"ALASKANS STANDING TOGETHER"
"USSEN/AK AKST THEY'RE BACK"	"AK"	"ALASKANS STANDING TOGETHER"
"USSEN/AK AKST THREE LEGGED STOOL"	"AK"	"ALASKANS STANDING TOGETHER"
"USSEN/AK CFG ALASKAN JOBS"	"AK"	"Club for Growth"
"USSEN/AK DSCC TURNED HER BACK"	"AK"	
"USSEN/AK MCADAMS NORWEGIAN"	"AK"	
"USSEN/AK MCADAMS PAYCHECK"	"AK"	
"USSEN/AK MCADAMS SITKA"	"AK"	
"USSEN/AK MCADAMS TIE RACK"	"AK"	
"USSEN/AK MILLER A LONG WAY"	"AK"	
"USSEN/AK MILLER CREDENTIALS"	"AK"	
"USSEN/AK MILLER CRISIS"	"AK"	
"USSEN/AK MILLER FIGHT"	"AK"	
"USSEN/AK MILLER HELLO VOTERS"	"AK"	
"USSEN/AK MILLER JOBS AND ENERGY"	"AK"	
"USSEN/AK MILLER MCMURSKI"	"AK"	
"USSEN/AK MILLER OBAMACARE"	"AK"	
"USSEN/AK MILLER OUT OF TOUCH"	"AK"	
"USSEN/AK MILLER PUZZLE"	"AK"	
"USSEN/AK MILLER REAL REPUBLICAN"	"AK"	
"USSEN/AK MILLER SHERRI WALL"	"AK"	
"USSEN/AK MILLER VOTED WITH OBAMA"	"AK"	
"USSEN/AK MILLER WEST POINT"	"AK"	
"USSEN/AK MILLER YES WE CAN"	"AK"	
"USSEN/AK MILLER&NRSC CHANGE DC"	"AK"	
"USSEN/AK MURKOWSKI ALASKA'S FUTURE 60"	"AK"	
"USSEN/AK MURKOWSKI ASK LISA"	"AK"	
"USSEN/AK MURKOWSKI DAVID SHEW"	"AK"	
"USSEN/AK MURKOWSKI DELIVERING"	"AK"	
"USSEN/AK MURKOWSKI ECONOMIC DISASTER"	"AK"	
"USSEN/AK MURKOWSKI FEDERAL FUNDS"	"AK"	
"USSEN/AK MURKOWSKI FIGHTING"	"AK"	
"USSEN/AK MURKOWSKI FILL IN WRITE IT IN"	"AK"	
"USSEN/AK MURKOWSKI GOVERNMENT OVERREACH"	"AK"	
"USSEN/AK MURKOWSKI IT'S ALASKA'S SEAT"	"AK"	
"USSEN/AK MURKOWSKI JOE'S AMERICA"	"AK"	
"USSEN/AK MURKOWSKI JOE'S HEADLINES"	"AK"	
"USSEN/AK MURKOWSKI OBAMA ADMINISTRATION"	"AK"	
"USSEN/AK MURKOWSKI SITKA"	"AK"	
"USSEN/AK MURKOWSKI SPELLING BEE"	"AK"	
"USSEN/AK MURKOWSKI SPELLING CLINIC 101"	"AK"	
"USSEN/AK MURKOWSKI TED STEVENS 60"	"AK"	
"USSEN/AK MURKOWSKI VISION"	"AK"	
"USSEN/AK MURKOWSKI WE AGREE"	"AK"	
"USSEN/AK MURKOWSKI WRITE IN CANDIDATE 60"	"AK"	
"USSEN/AK NRSC BANKRUPTING"	"AK"	
"USSEN/AK NRSC CHANGE DC"	"AK"	
"USSEN/AK NRSC CONTROL"	"AK"	
"USSEN/AK NRSC NATURAL RESOURCES"	"AK"	
"USSEN/AK NRSC RECORD"	"AK"	
"USSEN/AK NRT PROFESSIONAL PATRIOT"	"AK"	"National Republican Trust PAC"
"USSEN/AK NRWC FORCED UNIONISM 60"	"AK"	"National Right to Work Committee"
"USSEN/AK NWF SMOKESTACKS MURKOWSKI"	"AK"	"National Wildlife Federation Action Fund"
"USSEN/AK OCDB ARROGANT YOU LOST 60"	"AK"	"OUR COUNTRY DESERVES BETTER/ TEA PARTY EXPRESS"
"USSEN/AK OCDB HOW LIBERAL"	"AK"	"OUR COUNTRY DESERVES BETTER/ TEA PARTY EXPRESS"
"USSEN/AK OCDB MILLER'S ACCOMPLISHMENT"	"AK"	"OUR COUNTRY DESERVES BETTER/ TEA PARTY EXPRESS"
"USSEN/AK OCDB RIGHT DIRECTION"	"AK"	"OUR COUNTRY DESERVES BETTER/ TEA PARTY EXPRESS"
"USSEN/AK OCDB ROYAL FAMILY 60"	"AK"	"OUR COUNTRY DESERVES BETTER/ TEA PARTY EXPRESS"
"USSEN/AK OCDB SO LIBERAL"	"AK"	"OUR COUNTRY DESERVES BETTER/ TEA PARTY EXPRESS"
"USSEN/AR AFC BRAG"	"AR"	"Arkansans for Change"
"USSEN/AR AFC MOTHER"	"AR"	"Arkansans for Change"
"USSEN/AR AFC NO EVIDENCE"	"AR"	"Arkansans for Change"
"USSEN/AR AFC SHARON HANKINS"	"AR"	"Arkansans for Change"
"USSEN/AR AFC STOP PROTECTING WALL STREET"	"AR"	"Arkansans for Change"
"USSEN/AR AFC WORKING FOR"	"AR"	"Arkansans for Change"
"USSEN/AR AFC WORKING FOR REV"	"AR"	"Arkansans for Change"
"USSEN/AR AFSCME MOVERS 60"	"AR"	"AFSCME"
"USSEN/AR AFSCME PAC'D"	"AR"	"AFSCME"
"USSEN/AR AFSCME UP TO WASHINGTON"	"AR"	"AFSCME"
"USSEN/AR AHA OUT HERE"	"AR"	"American Hospital Association PAC"
"USSEN/AR AJS OUTSOURCING"	"AR"	"Americans for Job Security"
"USSEN/AR AJS THANK YOU"	"AR"	"Americans for Job Security"
"USSEN/AR ARCS BUY OUR SEAT"	"AR"	"Arkansans for Common Sense"
"USSEN/AR ARCS ROLL THE DICE"	"AR"	"Arkansans for Common Sense"
"USSEN/AR BAKER BEEN HERE BEFORE"	"AR"	
"USSEN/AR BAKER WASHINGTON IS BROKEN"	"AR"	
"USSEN/AR BOOZMAN CHRISTIAN UPBRINGING"	"AR"	
"USSEN/AR BOOZMAN CLOSING ARGUMENT"	"AR"	
"USSEN/AR BOOZMAN CONSERVATIVE VISION"	"AR"	
"USSEN/AR BOOZMAN FISHING"	"AR"	
"USSEN/AR BOOZMAN INDEPENDENT VOICE"	"AR"	
"USSEN/AR BOOZMAN STAND MY GROUND"	"AR"	
"USSEN/AR BOOZMAN STAND MY GROUND REV"	"AR"	
"USSEN/AR BOOZMAN STAND MY GROUND REV 2"	"AR"	
"USSEN/AR BOOZMAN SUNK"	"AR"	
"USSEN/AR BOOZMAN THANK YOU"	"AR"	
"USSEN/AR CARJ LINCOLN SAID NO"	"AR"	"Coalition for Arkansas Jobs"
"USSEN/AR COLEMAN CONSERVATIVE COMMENT"	"AR"	
"USSEN/AR CWA NO ACCIDENT"	"AR"	"Communications Workers of America"
"USSEN/AR CWA WORKS FOR AR"	"AR"	"Communications Workers of America"
"USSEN/AR CWA WORKS FOR AR REV"	"AR"	"Communications Workers of America"
"USSEN/AR CWA YOUR JOB COULD BE NEXT"	"AR"	"Communications Workers of America"
"USSEN/AR HALTER BAGGING GROCERIES"	"AR"	
"USSEN/AR HALTER CHANGE"	"AR"	
"USSEN/AR HALTER CHANGE REV"	"AR"	
"USSEN/AR HALTER FRIENDS"	"AR"	
"USSEN/AR HALTER JOBS"	"AR"	
"USSEN/AR HALTER MANY VOICES"	"AR"	
"USSEN/AR HALTER PAULINE"	"AR"	
"USSEN/AR HALTER PLAN"	"AR"	
"USSEN/AR HALTER PLAN REV"	"AR"	
"USSEN/AR HALTER PLAY BOOK"	"AR"	
"USSEN/AR HALTER PROTECT"	"AR"	
"USSEN/AR HALTER SIGNS"	"AR"	
"USSEN/AR HALTER SIGNS REV"	"AR"	
"USSEN/AR HALTER THE CHOICE"	"AR"	
"USSEN/AR HALTER VALUES"	"AR"	
"USSEN/AR HALTER WATCH HIM"	"AR"	
"USSEN/AR HALTER WHY BLANCHE"	"AR"	
"USSEN/AR LCV ANOTHER GUSHER"	"AR"	"League of Conservation Voters"
"USSEN/AR LINCOLN 184 YEARS"	"AR"	
"USSEN/AR LINCOLN BETTER FOR ARKANSAS"	"AR"	
"USSEN/AR LINCOLN BIG IDEA"	"AR"	
"USSEN/AR LINCOLN BREAKING NEWS"	"AR"	
"USSEN/AR LINCOLN CLINTON UNION THREAT"	"AR"	
"USSEN/AR LINCOLN DIFFERENCES THAT MATTER"	"AR"	
"USSEN/AR LINCOLN DOESN'T ADD UP"	"AR"	
"USSEN/AR LINCOLN DOLLAR BILL HALTER"	"AR"	
"USSEN/AR LINCOLN ENDORSED"	"AR"	
"USSEN/AR LINCOLN EXCITED ABOUT"	"AR"	
"USSEN/AR LINCOLN FINALLY TELLS US SOMETHING"	"AR"	
"USSEN/AR LINCOLN FISHTALE"	"AR"	
"USSEN/AR LINCOLN FLOOD"	"AR"	
"USSEN/AR LINCOLN INSTEAD"	"AR"	
"USSEN/AR LINCOLN NOT SAYING MUCH"	"AR"	
"USSEN/AR LINCOLN OUTSOURCING"	"AR"	
"USSEN/AR LINCOLN RECORD ON JOBS"	"AR"	
"USSEN/AR LINCOLN RESPONSE"	"AR"	
"USSEN/AR LINCOLN THE EXPERTS"	"AR"	
"USSEN/AR LINCOLN WE CAN AGAIN"	"AR"	
"USSEN/AR LINCOLN WHAT ABOUT"	"AR"	
"USSEN/AR LINCOLN WHAT IT'S LIKE"	"AR"	
"USSEN/AR LINCOLN WHAT'S RIGHT"	"AR"	
"USSEN/AR SEIU HOLLYWOOD FANTASIES"	"AR"	"SEIU"
"USSEN/AR SEIU NANCY SHAW"	"AR"	"SEIU"
"USSEN/AR SEIU NERVE"	"AR"	"SEIU"
"USSEN/AR SEIU ON TUESDAY"	"AR"	"SEIU"
"USSEN/AR SEIU REMEMBER"	"AR"	"SEIU"
"USSEN/AR SEIU TOUGH TIMES"	"AR"	"SEIU"
"USSEN/AR SEIU WALL STREET"	"AR"	"SEIU"
"USSEN/AR USCOC FARMS AND BUSINESSES LINCOLN"	"AR"	"US Chamber of Commerce"
"USSEN/AR USWA YOUR JOB COULD BE NEXT"	"AR"	"United Steel Workers"
"USSEN/AR USWA YOUR JOB COULD BE NEXT 2"	"AR"	"United Steel Workers"
"USSEN/AR USWA YOUR JOB COULD BE NEXT REV"	"AR"	"United Steel Workers"
"USSEN/AZ DOUGHERTY ARMY OF REGULAR PEOPLE"	"AZ"	
"USSEN/AZ GILYEAT CONSERVATIVE ALTERNATIVE 60"	"AZ"	
"USSEN/AZ GLASSMAN ARIZONA FIRST"	"AZ"	
"USSEN/AZ HAYWORTH I CHOSE LYING"	"AZ"	
"USSEN/AZ HAYWORTH MADE IT WORSE"	"AZ"	
"USSEN/AZ HAYWORTH MCCAIN'S AMNESTY BILL"	"AZ"	
"USSEN/AZ MCCAIN ASK"	"AZ"	
"USSEN/AZ MCCAIN ASK FOR"	"AZ"	
"USSEN/AZ MCCAIN BERNIE SPRAGUE"	"AZ"	
"USSEN/AZ MCCAIN BORDER SECURITY PLAN"	"AZ"	
"USSEN/AZ MCCAIN BUYER BEWARE"	"AZ"	
"USSEN/AZ MCCAIN BUYER BEWARE TUCSON"	"AZ"	
"USSEN/AZ MCCAIN CORRUPT POLITICIAN"	"AZ"	
"USSEN/AZ MCCAIN DRUG WAR"	"AZ"	
"USSEN/AZ MCCAIN FIGHT WE MUST WIN"	"AZ"	
"USSEN/AZ MCCAIN HAYWORTH AVID EARMARKER"	"AZ"	
"USSEN/AZ MCCAIN MILITARY BASES"	"AZ"	
"USSEN/AZ MCCAIN MILITARY ISSUES"	"AZ"	
"USSEN/AZ MCCAIN NOT SECURE"	"AZ"	
"USSEN/AZ MCCAIN ONE MAN"	"AZ"	
"USSEN/AZ MCCAIN SHERIFF BABEU"	"AZ"	
"USSEN/AZ MCCAIN SHERIFFS"	"AZ"	
"USSEN/AZ MCCAIN SUPPORTERS"	"AZ"	
"USSEN/AZ MCCAIN THE BORDER"	"AZ"	
"USSEN/AZ MCCAIN TOO GOOD TO BE TRUE"	"AZ"	
"USSEN/AZ MCCAIN TOO GOOD TO BE TRUE 60"	"AZ"	
"USSEN/AZ MCCAIN VITAL"	"AZ"	
"USSEN/AZ MCCAIN VITAL 60"	"AZ"	
"USSEN/AZ MCCAIN WASHINGTON LOBBYIST"	"AZ"	
"USSEN/AZ PARRAZ AMERICAN STORY"	"AZ"	
"USSEN/CA APIA OUR VALUES SP"	"CA"	"unknown"
"USSEN/CA BOXER MADE IN AMERICA"	"CA"	
"USSEN/CA BOXER NOT WITH US SP"	"CA"	
"USSEN/CA BOXER OUT OF TOUCH"	"CA"	
"USSEN/CA BOXER OUTSOURCING"	"CA"	
"USSEN/CA BOXER PRECISELY"	"CA"	
"USSEN/CA BOXER PRECISELY REV"	"CA"	
"USSEN/CA BOXER SHIPPED JOBS"	"CA"	
"USSEN/CA BOXER WORKERS"	"CA"	
"USSEN/CA BOXER&DSCC OUT OF TOUCH"	"CA"	
"USSEN/CA BOXER&DSCC PRECISELY"	"CA"	
"USSEN/CA BOXER&DSCC SHIPPED JOBS"	"CA"	
"USSEN/CA BOXER&DSCC WORKERS"	"CA"	
"USSEN/CA CABBABE REAGAN LEGACY"	"CA"	"Californians for a Balanced Budget and a Better Economy"
"USSEN/CA CAMPBELL CLEAR ALTERNATIVE"	"CA"	
"USSEN/CA CAMPBELL HISTORIC OPPORTUNITY"	"CA"	
"USSEN/CA CFTIP BARBARA BOXER'S CLOCK"	"CA"	"Committee for Truth in Politics"
"USSEN/CA CROSSROADSGPS BOXER"	"CA"	"Crossroads Grassroots Policy Strategies"
"USSEN/CA DEVORE PROUD ENDORSEMENTS"	"CA"	
"USSEN/CA DEVORE TOM MCCLINTOCK"	"CA"	
"USSEN/CA FIORINA BICKERING"	"CA"	
"USSEN/CA FIORINA BUCK"	"CA"	
"USSEN/CA FIORINA CRUSHED"	"CA"	
"USSEN/CA FIORINA DAY"	"CA"	
"USSEN/CA FIORINA EGOMANIAC"	"CA"	
"USSEN/CA FIORINA EGOMANIAC 15"	"CA"	
"USSEN/CA FIORINA JOBS"	"CA"	
"USSEN/CA FIORINA LABEL"	"CA"	
"USSEN/CA FIORINA NATIONAL SECURITY"	"CA"	
"USSEN/CA FIORINA THINKING CAMPBELL"	"CA"	
"USSEN/CA FIORINA WORK"	"CA"	
"USSEN/CA ICAUCUS CHUCK DEVORE"	"CA"	"Independence Caucus"
"USSEN/CA KAUS NO POLITICIAN"	"CA"	
"USSEN/CA NOM TWO PEAS SAME LIBERAL POD"	"CA"	"National Organization for Marriage"
"USSEN/CA NOM&SBALIST OUR VALUES SP"	"CA"	"National Organization for Marriage and Susan B Anthony List"
"USSEN/CA NRSC BICKERING"	"CA"	
"USSEN/CA NRSC NOTHING WILL CHANGE"	"CA"	
"USSEN/CA NRSC&FIORINA CRUSHED"	"CA"	
"USSEN/CA NRSC&FIORINA DAY"	"CA"	
"USSEN/CA NRSC&FIORINA LABEL"	"CA"	
"USSEN/CA TAXPAYERNETWORK RECORD"	"CA"	"Taxpayer Network"
"USSEN/CA TAXPAYERNETWORK RECORD REV"	"CA"	"Taxpayer Network"
"USSEN/CA TAXPAYERNETWORK REPRESENT US"	"CA"	"Taxpayer Network"
"USSEN/CA USCOC 28 YEARS"	"CA"	"US Chamber of Commerce"
"USSEN/CA USCOC BAD WITH OUR MONEY"	"CA"	"US Chamber of Commerce"
"USSEN/CA USCOC WATER MEANS JOBS BAKERSFIELD"	"CA"	"US Chamber of Commerce"
"USSEN/CA USCOC WATER MEANS JOBS CENTRAL VAL"	"CA"	"US Chamber of Commerce"
"USSEN/CA USCOC WATER MEANS JOBS FRESNO"	"CA"	"US Chamber of Commerce"
"USSEN/CA USCOC WATER MEANS JOBS SAN DIEGO"	"CA"	"US Chamber of Commerce"
"USSEN/CA WOMENVOTE OPERA"	"CA"	"Women Vote"
"USSEN/CO AFSCME HIGH HEELS"	"CO"	"AFSCME"
"USSEN/CO AJS AT THE BRINK"	"CO"	"Americans for Job Security"
"USSEN/CO AJS BACK TO WORK"	"CO"	"Americans for Job Security"
"USSEN/CO AJS PROTECT"	"CO"	"Americans for Job Security"
"USSEN/CO AJS TALK IS CHEAP"	"CO"	"Americans for Job Security"
"USSEN/CO AJS TAX DAY"	"CO"	"Americans for Job Security"
"USSEN/CO AJS TAX DAY REV"	"CO"	"Americans for Job Security"
"USSEN/CO AMERICANCROSSROADS DECIDING VOTE"	"CO"	"American Crossroads"
"USSEN/CO AMERICANCROSSROADS GAMBLE"	"CO"	"American Crossroads"
"USSEN/CO AMERICANCROSSROADS MORE"	"CO"	"American Crossroads"
"USSEN/CO AMERICANCROSSROADS OUTRAGED"	"CO"	"American Crossroads"
"USSEN/CO AMERICANCROSSROADS SHORTFALL"	"CO"	"American Crossroads"
"USSEN/CO BENNET BARACK OBAMA"	"CO"	
"USSEN/CO BENNET BUCK EXTREME ON ABORTION"	"CO"	
"USSEN/CO BENNET BUCK EXTREME ON ABORTION 15"	"CO"	
"USSEN/CO BENNET BUCK EXTREMELY WRONG"	"CO"	
"USSEN/CO BENNET CLEANED UP"	"CO"	
"USSEN/CO BENNET CLEANED UP REV"	"CO"	
"USSEN/CO BENNET COMMON SENSE"	"CO"	
"USSEN/CO BENNET DESPICABLE CAMPAIGN"	"CO"	
"USSEN/CO BENNET DR ELIZA"	"CO"	
"USSEN/CO BENNET DYSLEXIA"	"CO"	
"USSEN/CO BENNET DYSLEXIA SP"	"CO"	
"USSEN/CO BENNET EXTREME ON STUDENT LOANS"	"CO"	
"USSEN/CO BENNET EXTREME STUDENT LOANS 15"	"CO"	
"USSEN/CO BENNET GET OUT THE VOTE TODAY"	"CO"	
"USSEN/CO BENNET GET OUT THE VOTE TODAY REV"	"CO"	
"USSEN/CO BENNET IMPORTANT"	"CO"	
"USSEN/CO BENNET JOB ONE"	"CO"	
"USSEN/CO BENNET KEN BUCK'S EXTREMES"	"CO"	
"USSEN/CO BENNET KEN BUCK'S PLAN"	"CO"	
"USSEN/CO BENNET KEN BUCK'S PRICE TAG"	"CO"	
"USSEN/CO BENNET LESSONS SP"	"CO"	
"USSEN/CO BENNET OVER THE TOP"	"CO"	
"USSEN/CO BENNET OVER THE TOP REV"	"CO"	
"USSEN/CO BENNET OVER THE TOP REV 2"	"CO"	
"USSEN/CO BENNET PAYBACK 15"	"CO"	
"USSEN/CO BENNET SOLVING PROBLEMS"	"CO"	
"USSEN/CO BENNET STANDING UP FOR US"	"CO"	
"USSEN/CO BENNET THE TRUTH"	"CO"	
"USSEN/CO BENNET THIS WASHINGTON"	"CO"	
"USSEN/CO BENNET WAKE UP"	"CO"	
"USSEN/CO BENNET WHO IS KEN BUCK"	"CO"	
"USSEN/CO BENNET WHO IS KEN BUCK 60"	"CO"	
"USSEN/CO BENNET YOUR SENATOR"	"CO"	
"USSEN/CO BENNET&DNC EDUCATION SP"	"CO"	
"USSEN/CO BUCK BANKRUPT"	"CO"	
"USSEN/CO BUCK GOOD MAN"	"CO"	
"USSEN/CO BUCK IGNORE US"	"CO"	
"USSEN/CO BUCK KAITLIN"	"CO"	
"USSEN/CO BUCK LEADER"	"CO"	
"USSEN/CO BUCK OPPORTUNITY"	"CO"	
"USSEN/CO BUCK UNFAIR"	"CO"	
"USSEN/CO C4SS SMALL BUSINESS BENNET"	"CO"	"Citizens for Strength and Security"
"USSEN/CO CFG ENOUGH"	"CO"	"Club for Growth"
"USSEN/CO CFL STEALING LIBERTY"	"CO"	"2010 Campaign for Liberty"
"USSEN/CO CMW THE GUN DEALER"	"CO"	"Public Campaign Action Fund's Campaign Money Watch"
"USSEN/CO COPAC EDUCATION SP"	"CO"	"Colorado Progressive Action"
"USSEN/CO COPAC EDUCATION SP REV"	"CO"	"Colorado Progressive Action"
"USSEN/CO COPAC IMMIGRATION SP"	"CO"	"Colorado Progressive Action"
"USSEN/CO CROSSROADSGPS BENNET CALENDAR"	"CO"	"Crossroads Grassroots Policy Strategies"
"USSEN/CO CROSSROADSGPS DEEP IN DEBT"	"CO"	"Crossroads Grassroots Policy Strategies"
"USSEN/CO CROSSROADSGPS DEEP IN DEBT REV"	"CO"	"Crossroads Grassroots Policy Strategies"
"USSEN/CO DA BIG GOVERNMENT EXCUSES"	"CO"	"Declaration Alliance"
"USSEN/CO DSCC BIRTH CONTROL"	"CO"	
"USSEN/CO DSCC DOESN'T GET IT"	"CO"	
"USSEN/CO DSCC JUST CAN'T"	"CO"	
"USSEN/CO DSCC LISTEN"	"CO"	
"USSEN/CO DSCC OUT THERE"	"CO"	
"USSEN/CO DSCC OUTRAGEOUS"	"CO"	
"USSEN/CO DSCC PLAN"	"CO"	
"USSEN/CO DSCC REPRESENT COLORADO"	"CO"	
"USSEN/CO DSCC SECRET"	"CO"	
"USSEN/CO DSCC SOCIAL SECURITY"	"CO"	
"USSEN/CO DSCC TOO EXTREME"	"CO"	
"USSEN/CO FAA RESTORE SANITY"	"CO"	"First Amendment Alliance"
"USSEN/CO GOP ETHICAL ABUSES"	"CO"	"Grow Our Party"
"USSEN/CO NAPOLITANO ACCOUNTABLE"	"CO"	
"USSEN/CO NAPOLITANO GRASSHOPPER"	"CO"	
"USSEN/CO NAPOLITANO NEW APPROACH"	"CO"	
"USSEN/CO NEA BUCK'S MATH"	"CO"	"NEA"
"USSEN/CO NORTON BACKBONE"	"CO"	
"USSEN/CO NORTON HIGH HEELS"	"CO"	
"USSEN/CO NORTON MR PRESIDENT"	"CO"	
"USSEN/CO NORTON OBLIGATIONS"	"CO"	
"USSEN/CO NORTON OFF TRACK"	"CO"	
"USSEN/CO NRA KEN BUCK"	"CO"	"NRA"
"USSEN/CO NRSC CHALLENGES"	"CO"	
"USSEN/CO NRSC HABIT"	"CO"	
"USSEN/CO NRSC HEALTH CARE"	"CO"	
"USSEN/CO NRSC LISTENING"	"CO"	
"USSEN/CO NRSC ONE VOTE"	"CO"	
"USSEN/CO NRSC OUR SENATOR"	"CO"	
"USSEN/CO NRSC&BUCK GOOD MAN"	"CO"	
"USSEN/CO ROMANOFF BENNET'S BET GONE BAD"	"CO"	
"USSEN/CO ROMANOFF FOR THE REST OF US"	"CO"	
"USSEN/CO ROMANOFF I STAND WITH YOU"	"CO"	
"USSEN/CO ROMANOFF LOSING SP"	"CO"	
"USSEN/CO ROMANOFF THE TRUTH"	"CO"	
"USSEN/CO ROMANOFF WALL STREET"	"CO"	
"USSEN/CO SCF ENOUGH"	"CO"	"Senate Conservative Fund"
"USSEN/CO USCOC CHANGE"	"CO"	"US Chamber of Commerce"
"USSEN/CO USCOC LOST JOBS"	"CO"	"US Chamber of Commerce"
"USSEN/CO WVWV HIGH HEELS"	"CO"	"Women Vote"
"USSEN/CT BLUMENTHAL ALDERMAN MOTORS"	"CT"	
"USSEN/CT BLUMENTHAL EVERYWHERE"	"CT"	
"USSEN/CT BLUMENTHAL FALSE ATTACK"	"CT"	
"USSEN/CT BLUMENTHAL FIGHT FOR YOU"	"CT"	
"USSEN/CT BLUMENTHAL GARY & GAYLE"	"CT"	
"USSEN/CT BLUMENTHAL GARY & GAYLE REV"	"CT"	
"USSEN/CT BLUMENTHAL INTERESTS"	"CT"	
"USSEN/CT BLUMENTHAL LATEST ATTACK"	"CT"	
"USSEN/CT BLUMENTHAL LAURA & SKYLER"	"CT"	
"USSEN/CT BLUMENTHAL LAURA & SKYLER REV"	"CT"	
"USSEN/CT BLUMENTHAL PROTECTING SOUND"	"CT"	
"USSEN/CT BLUMENTHAL SARAH"	"CT"	
"USSEN/CT BLUMENTHAL SARAH REV"	"CT"	
"USSEN/CT BLUMENTHAL SETTING RECORD STRAIGHT"	"CT"	
"USSEN/CT BLUMENTHAL STAND UP"	"CT"	
"USSEN/CT BLUMENTHAL VOICES"	"CT"	
"USSEN/CT DSCC BAD"	"CT"	
"USSEN/CT DSCC CONTRACTS"	"CT"	
"USSEN/CT DSCC MEMO"	"CT"	
"USSEN/CT HILL BLIND PARTISANSHIP"	"CT"	
"USSEN/CT HILL BROKEN"	"CT"	
"USSEN/CT HILL CHINA"	"CT"	
"USSEN/CT HILL LAUGHING STOCK"	"CT"	
"USSEN/CT HILL MOTHER AND DAUGHTER"	"CT"	
"USSEN/CT HILL VOTE FOR THE RIGHT PERSON 60"	"CT"	
"USSEN/CT HILL WONT SEE HIS NAME 60"	"CT"	
"USSEN/CT MCMAHON BACK TO WORK"	"CT"	
"USSEN/CT MCMAHON BUSINESSWOMAN SP"	"CT"	
"USSEN/CT MCMAHON CAN'T AFFORD TAX"	"CT"	
"USSEN/CT MCMAHON CAN'T CREATE JOBS"	"CT"	
"USSEN/CT MCMAHON CHANGE SP"	"CT"	
"USSEN/CT MCMAHON CUP OF TEA"	"CT"	
"USSEN/CT MCMAHON DESPERATE ATTACKS"	"CT"	
"USSEN/CT MCMAHON DIFFERENT"	"CT"	
"USSEN/CT MCMAHON GROWING UP 60"	"CT"	
"USSEN/CT MCMAHON I LIKE"	"CT"	
"USSEN/CT MCMAHON JOBS"	"CT"	
"USSEN/CT MCMAHON JOBS PLAN"	"CT"	
"USSEN/CT MCMAHON JUDY"	"CT"	
"USSEN/CT MCMAHON KEPT HER WORD"	"CT"	
"USSEN/CT MCMAHON LIED"	"CT"	
"USSEN/CT MCMAHON LUNCHBOX"	"CT"	
"USSEN/CT MCMAHON MATTER OF POLITICS"	"CT"	
"USSEN/CT MCMAHON RALLY 60"	"CT"	
"USSEN/CT MCMAHON REGULAR JOB 60"	"CT"	
"USSEN/CT MCMAHON REVOLVING DOOR"	"CT"	
"USSEN/CT MCMAHON RUNNING TO BE VOICE 60"	"CT"	
"USSEN/CT MCMAHON STAND UP"	"CT"	
"USSEN/CT MCMAHON TAKING CARE 60"	"CT"	
"USSEN/CT MCMAHON TRUTH"	"CT"	
"USSEN/CT MCMAHON TWO WORDS"	"CT"	
"USSEN/CT MCMAHON WHAT ELSE"	"CT"	
"USSEN/CT MCMAHON WHEN I WAS YOUNG"	"CT"	
"USSEN/CT MCMAHON WHITEBOARD"	"CT"	
"USSEN/CT MCMAHON WHO IS"	"CT"	
"USSEN/CT MCMAHON WHO IS REV"	"CT"	
"USSEN/CT SCHIFF KICK"	"CT"	
"USSEN/CT SCHIFF TRICK"	"CT"	
"USSEN/CT SIMMONS ISSUES"	"CT"	
"USSEN/CT SIMMONS LEST WE FORGET"	"CT"	
"USSEN/CT SIMMONS MY LIFE"	"CT"	
"USSEN/CT USCOC CHANGE"	"CT"	"US Chamber of Commerce"
"USSEN/CT USCOC CRUSHING"	"CT"	"US Chamber of Commerce"
"USSEN/CT WHITNUM FIGHTING FUNDING"	"CT"	
"USSEN/DE C4SS JOBS COONS"	"DE"	"Citizens for Strength and Security"
"USSEN/DE CASTLE SNAPSHOT"	"DE"	
"USSEN/DE COONS FINANCES"	"DE"	
"USSEN/DE COONS JOBS"	"DE"	
"USSEN/DE COONS PLAN FOR WASHINGTON"	"DE"	
"USSEN/DE COONS STRANGE THINGS"	"DE"	
"USSEN/DE NRT CHOOSE"	"DE"	"National Republican Trust PAC"
"USSEN/DE O'DONNELL COONS THE TAXMAN"	"DE"	
"USSEN/DE O'DONNELL I'M YOU"	"DE"	
"USSEN/DE O'DONNELL MICHAEL BROWN"	"DE"	
"USSEN/DE O'DONNELL STAND FOR PRINCIPLES"	"DE"	
"USSEN/DE O'DONNELL WHAT I'M MADE OF"	"DE"	
"USSEN/FL AAN CAN'T TRUST CHARLIE CRIST"	"FL"	"American Action Network"
"USSEN/FL CFG ENOUGH"	"FL"	"Club for Growth"
"USSEN/FL CRIST BEST OF BOTH"	"FL"	
"USSEN/FL CRIST CROSS THE LINE"	"FL"	
"USSEN/FL CRIST CROSSROADS"	"FL"	
"USSEN/FL CRIST INDEPENDENCE"	"FL"	
"USSEN/FL CRIST INTEGRITY"	"FL"	
"USSEN/FL CRIST LINE IN THE SAND"	"FL"	
"USSEN/FL CRIST PROTECT"	"FL"	
"USSEN/FL CRIST PROTECT REV"	"FL"	
"USSEN/FL CRIST SANSOM AND RUBIO"	"FL"	
"USSEN/FL CRIST THOUGHT HE WAS DIFFERENT"	"FL"	
"USSEN/FL CRIST VETOED"	"FL"	
"USSEN/FL CRIST WHAT DO WE REALLY KNOW"	"FL"	
"USSEN/FL CROSSROADSGPS CHOICE"	"FL"	"Crossroads Grassroots Policy Strategies"
"USSEN/FL CROSSROADSGPS COLORS"	"FL"	"Crossroads Grassroots Policy Strategies"
"USSEN/FL CWF RESTORE AMERICA"	"FL"	"Campaign for Working Families"
"USSEN/FL FLDP&MEEK OWN WORDS"	"FL"	
"USSEN/FL GREENE A BETTER CHOICE"	"FL"	
"USSEN/FL GREENE CROOKED"	"FL"	
"USSEN/FL GREENE FAILED"	"FL"	
"USSEN/FL GREENE FALSE NEGATIVE ATTACKS"	"FL"	
"USSEN/FL GREENE FAMILY"	"FL"	
"USSEN/FL GREENE FAMILY SP"	"FL"	
"USSEN/FL GREENE FRUSTRATING 15"	"FL"	
"USSEN/FL GREENE JEFF GREENE'S STORY 60"	"FL"	
"USSEN/FL GREENE JOBS"	"FL"	
"USSEN/FL GREENE MOM"	"FL"	
"USSEN/FL GREENE NEVER LET YOU DOWN"	"FL"	
"USSEN/FL GREENE NEWSPAPER ENDORSEMENTS"	"FL"	
"USSEN/FL GREENE ONE MILLION"	"FL"	
"USSEN/FL GREENE OUTSIDER"	"FL"	
"USSEN/FL GREENE PRIORITY 15"	"FL"	
"USSEN/FL GREENE REAL PLAN"	"FL"	
"USSEN/FL GREENE STORY"	"FL"	
"USSEN/FL GREENE SURPRISED"	"FL"	
"USSEN/FL GREENE TESTIMONIALS"	"FL"	
"USSEN/FL GREENE TOO CORRUPT"	"FL"	
"USSEN/FL GREENE TYPICAL"	"FL"	
"USSEN/FL GREENE TYPICAL REV"	"FL"	
"USSEN/FL GREENE UNFIT"	"FL"	
"USSEN/FL GREENE WHO"	"FL"	
"USSEN/FL MEEK ALL SUPPORT"	"FL"	
"USSEN/FL MEEK CAN BUY ANYTHING"	"FL"	
"USSEN/FL MEEK HE'S THE MAN"	"FL"	
"USSEN/FL MEEK MY LIFE"	"FL"	
"USSEN/FL MEEK ONLY ONE"	"FL"	
"USSEN/FL NOAH FAIR TAX"	"FL"	
"USSEN/FL RUBIO A GENERATIONAL CHOICE 120"	"FL"	
"USSEN/FL RUBIO ACCIDENT"	"FL"	
"USSEN/FL RUBIO BACKWARDS"	"FL"	
"USSEN/FL RUBIO BETTER 15"	"FL"	
"USSEN/FL RUBIO CHILDREN 60"	"FL"	
"USSEN/FL RUBIO DREAM"	"FL"	
"USSEN/FL RUBIO FEAR MONGERING"	"FL"	
"USSEN/FL RUBIO JOB CREATION SP"	"FL"	
"USSEN/FL RUBIO MOST IMPORTANT"	"FL"	
"USSEN/FL RUBIO NEXT"	"FL"	
"USSEN/FL RUBIO NOISE"	"FL"	
"USSEN/FL RUBIO PARENTS SP"	"FL"	
"USSEN/FL RUBIO WE ALL KNOW"	"FL"	
"USSEN/FL RUBIO YES 15"	"FL"	
"USSEN/FL RUBIO YOUR PARTICIPATION SP"	"FL"	
"USSEN/FL RUBIO&NRSC ACCIDENT"	"FL"	
"USSEN/FL RUBIO&NRSC MOST IMPORTANT"	"FL"	
"USSEN/FL SNITKER TRAVESTY"	"FL"	
"USSEN/FL TPA STOP THE BAILOUT"	"FL"	"Tea Party in Action"
"USSEN/FL USCOC THE FLIP FLOPPER 60"	"FL"	"US Chamber of Commerce"
"USSEN/GA ISAKSON CONSERVATIVE BELIEFS"	"GA"	
"USSEN/GA ISAKSON FIGHTING FOR GEORGIA"	"GA"	
"USSEN/GA ISAKSON FIGHTING TO PROTECT AMERICA"	"GA"	
"USSEN/GA ISAKSON FRIDAY NIGHTS"	"GA"	
"USSEN/GA ISAKSON GEORGIA JOBS"	"GA"	
"USSEN/GA ISAKSON NEIGHBORHOODS"	"GA"	
"USSEN/GA ISAKSON PADS AND HELMETS"	"GA"	
"USSEN/GA ISAKSON STARTING OVER"	"GA"	
"USSEN/GA ISAKSON THE CHOICE"	"GA"	
"USSEN/GA THURMOND TIRED"	"GA"	
"USSEN/HI CAVASSO CRAZY"	"HI"	
"USSEN/HI CAVASSO MOUNTAINS OF DEBT"	"HI"	
"USSEN/HI HIDP COMMON COURTESY"	"HI"	
"USSEN/HI INOUYE DAN IS WORKING"	"HI"	
"USSEN/HI INOUYE DOING YOUR BEST"	"HI"	
"USSEN/HI INOUYE JUST CALL ME DAN"	"HI"	
"USSEN/HI INOUYE JUST CALL ME DAN 60"	"HI"	
"USSEN/HI INOUYE WASHINGTON"	"HI"	
"USSEN/HI INOUYE WASHINGTON 60"	"HI"	
"USSEN/HI INOUYE WORKING FOR HAWAII"	"HI"	
"USSEN/IA CONLIN AL BODE"	"IA"	
"USSEN/IA CONLIN CHANGED"	"IA"	
"USSEN/IA CONLIN COUNTING ON YOU"	"IA"	
"USSEN/IA CONLIN DISAPPEARING"	"IA"	
"USSEN/IA CONLIN TAKE ON"	"IA"	
"USSEN/IA CONLIN TAKE ON REV"	"IA"	
"USSEN/IA GRASSLEY APPRECIATE"	"IA"	
"USSEN/IA GRASSLEY BANANAS"	"IA"	
"USSEN/IA GRASSLEY BLUNT"	"IA"	
"USSEN/IA GRASSLEY END SECRET HOLDS"	"IA"	
"USSEN/IA GRASSLEY END SECRET HOLDS REV"	"IA"	
"USSEN/IA GRASSLEY HE WROTE THE BILL"	"IA"	
"USSEN/IA GRASSLEY LEARN"	"IA"	
"USSEN/IA GRASSLEY LIGHTNING"	"IA"	
"USSEN/IA GRASSLEY TWITTER"	"IA"	
"USSEN/IA GRASSLEY WHAT MATTERS"	"IA"	
"USSEN/IA GRASSLEY WHISTLE"	"IA"	
"USSEN/IA GRASSLEY WHO"	"IA"	
"USSEN/IA GRASSLEY WORKS FOR IOWA 60"	"IA"	
"USSEN/IA GRASSLEY WORKS FOR US"	"IA"	
"USSEN/ID CRAPO HARD FACTS"	"ID"	
"USSEN/ID CRAPO PROTECT JOBS"	"ID"	
"USSEN/ID CRAPO WORKS FOR IDAHO"	"ID"	
"USSEN/IL AMERICANCROSSROADS DRIVER ERROR"	"IL"	"American Crossroads"
"USSEN/IL CROSSROADSGPS CLAIM"	"IL"	"Crossroads Grassroots Policy Strategies"
"USSEN/IL CROSSROADSGPS CONSISTENT"	"IL"	"Crossroads Grassroots Policy Strategies"
"USSEN/IL CROSSROADSGPS KNOWN"	"IL"	"Crossroads Grassroots Policy Strategies"
"USSEN/IL DABNEY INDEPENDENT"	"IL"	
"USSEN/IL DABNEY WRITE IN"	"IL"	
"USSEN/IL DABNEY WRITE IN 2"	"IL"	
"USSEN/IL DSCC HONOR"	"IL"	
"USSEN/IL DSCC INDEPENDENT"	"IL"	
"USSEN/IL DSCC LEVEL"	"IL"	
"USSEN/IL DSCC PROBLEMS"	"IL"	
"USSEN/IL DSCC WHICH DISTRICT"	"IL"	
"USSEN/IL GIANNOULIAS BUSH POLICIES"	"IL"	
"USSEN/IL GIANNOULIAS CAN'T TRUST A WORD"	"IL"	
"USSEN/IL GIANNOULIAS CAUGHT IN A LIE"	"IL"	
"USSEN/IL GIANNOULIAS DREAM SP"	"IL"	
"USSEN/IL GIANNOULIAS FACT"	"IL"	
"USSEN/IL GIANNOULIAS FALSE ATTACKS"	"IL"	
"USSEN/IL GIANNOULIAS FIGHTER 60"	"IL"	
"USSEN/IL GIANNOULIAS HEART"	"IL"	
"USSEN/IL GIANNOULIAS KIRK LIES"	"IL"	
"USSEN/IL GIANNOULIAS MY LEFT FOOT"	"IL"	
"USSEN/IL GIANNOULIAS PHENOMENAL"	"IL"	
"USSEN/IL GIANNOULIAS PLAN FOR JOBS"	"IL"	
"USSEN/IL GIANNOULIAS SPECIAL INTERESTS"	"IL"	
"USSEN/IL GIANNOULIAS STANDING UP FOR JOBS"	"IL"	
"USSEN/IL GIANNOULIAS THE CHOICE ETHICS"	"IL"	
"USSEN/IL GIANNOULIAS VALUES"	"IL"	
"USSEN/IL GIANNOULIAS VALUES REV"	"IL"	
"USSEN/IL GIANNOULIAS&DSCC FACT"	"IL"	
"USSEN/IL GIANNOULIAS&DSCC PHENOMENAL"	"IL"	
"USSEN/IL GIANNOULIAS&DSCC THE CHOICE ETHICS"	"IL"	
"USSEN/IL GIANNOULIAS&DSCC THE CHOICE HARTMARX"	"IL"	
"USSEN/IL GIANNOULIAS&DSCC TOUGH"	"IL"	
"USSEN/IL GIANNOULIAS&ILDP CAN'T TRUST A WORD"	"IL"	
"USSEN/IL HOFFMAN A BETTER CHOICE"	"IL"	
"USSEN/IL HOFFMAN A BETTER CHOICE REV"	"IL"	
"USSEN/IL HOFFMAN PROMISES"	"IL"	
"USSEN/IL ILDP&GIANNOULIAS PHENOMENAL"	"IL"	
"USSEN/IL ILDP&GIANNOULIAS PHENOMENAL REV"	"IL"	
"USSEN/IL JACKSON NO SUCH THING"	"IL"	
"USSEN/IL KIRK ALEXI'S PRIORITIES"	"IL"	
"USSEN/IL KIRK DEFICIT HAWK"	"IL"	
"USSEN/IL KIRK DISTRACT"	"IL"	
"USSEN/IL KIRK FAMILIES SP"	"IL"	
"USSEN/IL KIRK HER DEBT"	"IL"	
"USSEN/IL KIRK INDEPENDENT"	"IL"	
"USSEN/IL KIRK LEADERSHIP FOR ILLINOIS"	"IL"	
"USSEN/IL KIRK LEADERSHIP FOR ILLINOIS REV"	"IL"	
"USSEN/IL KIRK MR INDEPENDENT"	"IL"	
"USSEN/IL KIRK NEVER RECOVER"	"IL"	
"USSEN/IL KIRK RECKLESS"	"IL"	
"USSEN/IL KIRK RISKY"	"IL"	
"USSEN/IL KIRK STAND"	"IL"	
"USSEN/IL KIRK TRUTH"	"IL"	
"USSEN/IL KIRK WHAT DO YOU CALL"	"IL"	
"USSEN/IL KIRK WHAT DO YOU CALL REV"	"IL"	
"USSEN/IL KIRK&NRSC DEFICIT HAWK"	"IL"	
"USSEN/IL KIRK&NRSC HER DEBT"	"IL"	
"USSEN/IL KIRK&NRSC MR INDEPENDENT"	"IL"	
"USSEN/IL KIRK&NRSC RECKLESS"	"IL"	
"USSEN/IL KIRK&NRSC TRUST"	"IL"	
"USSEN/IL KIRK&NRSC TRUTH"	"IL"	
"USSEN/IL KIRK&NRSC TWO CANDIDATES"	"IL"	
"USSEN/IL KIRK&NRSC WHAT DO YOU CALL"	"IL"	
"USSEN/IL KIRK&NRSC WHAT DO YOU CALL REV"	"IL"	
"USSEN/IL LOWERY TIRED OF POLITICIANS"	"IL"	
"USSEN/IL MARSHALL CAP AND TRADE"	"IL"	
"USSEN/IL MARSHALL HEALTHCARE REFORM"	"IL"	
"USSEN/IL MARSHALL MARSHALL FOR US SENATE"	"IL"	
"USSEN/IL MOVEON CONNECT THE DOTS"	"IL"	"MoveOn"
"USSEN/IL MOVEON OUR AD"	"IL"	"MoveOn"
"USSEN/IL NRSC TAX INCREASE"	"IL"	
"USSEN/IL USCOC PUBLIC'S MONEY"	"IL"	"US Chamber of Commerce"
"USSEN/IL USCOC UNEMPLOYMENT"	"IL"	"US Chamber of Commerce"
"USSEN/IL USCOC UNEMPLOYMENT REV"	"IL"	"US Chamber of Commerce"
"USSEN/IL WFUPAC YES MAN"	"IL"	"Working for Us PAC"
"USSEN/IN COATS BETTER DAYS"	"IN"	
"USSEN/IN COATS DIFFERENCES MATTER"	"IN"	
"USSEN/IN COATS HAS A PROBLEM"	"IN"	
"USSEN/IN COATS HIGHEST LEVEL"	"IN"	
"USSEN/IN COATS JUDGMENT"	"IN"	
"USSEN/IN COATS STAND UP"	"IN"	
"USSEN/IN COATS STEP UP"	"IN"	
"USSEN/IN COATS THE CHOICE"	"IN"	
"USSEN/IN COATS THE DIFFERENCE"	"IN"	
"USSEN/IN COATS VOTE TO CUT MEDICARE"	"IN"	
"USSEN/IN ELLSWORTH AT STAKE"	"IN"	
"USSEN/IN ELLSWORTH PAID"	"IN"	
"USSEN/IN ELLSWORTH SOLD OUT"	"IN"	
"USSEN/IN ELLSWORTH THINK"	"IN"	
"USSEN/IN INDP PAID"	"IN"	
"USSEN/IN NRWC FORCED UNIONISM 60"	"IN"	"National Right to Work Committee"
"USSEN/IN STUTZMAN AUTHENTIC CONSERVATIVE"	"IN"	
"USSEN/IN STUTZMAN TUESDAY MORNING"	"IN"	
"USSEN/IN USCOC VOTED FOR TRILLIONS"	"IN"	"US Chamber of Commerce"
"USSEN/KS JOHNSTON BREAKING THE CYCLE"	"KS"	
"USSEN/KS JOHNSTON CAREER POLITICS"	"KS"	
"USSEN/KS JOHNSTON UNFAIR TAX"	"KS"	
"USSEN/KS MORAN A LOT OF ROADS"	"KS"	
"USSEN/KS MORAN FALSE ATTACKS"	"KS"	
"USSEN/KS MORAN LAVISH DINNERS"	"KS"	
"USSEN/KS MORAN NO INTEREST"	"KS"	
"USSEN/KS MORAN PROVEN"	"KS"	
"USSEN/KS MORAN PROVEN INTEGRITY"	"KS"	
"USSEN/KS MORAN QUOTES"	"KS"	
"USSEN/KS MORAN TAX CODE"	"KS"	
"USSEN/KS MORAN THE FACTS"	"KS"	
"USSEN/KS MORAN TRUTH TEST"	"KS"	
"USSEN/KS MORAN UNDERSTANDS"	"KS"	
"USSEN/KS MORAN UNIQUE DIFFERENCES"	"KS"	
"USSEN/KS MORAN VOTE TUESDAY"	"KS"	
"USSEN/KS TIAHRT GRACIA BURNHAM"	"KS"	
"USSEN/KS TIAHRT HEADLINES"	"KS"	
"USSEN/KS TIAHRT I LOVE AMERICA"	"KS"	
"USSEN/KS TIAHRT MORAN WINCED"	"KS"	
"USSEN/KS TIAHRT OUT OF CONTROL"	"KS"	
"USSEN/KS TIAHRT STAND TALL"	"KS"	
"USSEN/KS TIAHRT TEA PARTY MOVEMENT HERO"	"KS"	
"USSEN/KY AFF KENTUCKY VALUES"	"KY"	"American Future Fund"
"USSEN/KY AMERICANCROSSROADS COMMON SENSE"	"KY"	"American Crossroads"
"USSEN/KY AMERICANCROSSROADS PUZZLE"	"KY"	"American Crossroads"
"USSEN/KY AMERICANCROSSROADS SLICK JACK"	"KY"	"American Crossroads"
"USSEN/KY CFL CONWAY'S AGENDA"	"KY"	"Campaign for Liberty"
"USSEN/KY COMMONSENSETEN PRESSING"	"KY"	"Commonsense Ten"
"USSEN/KY COMMONSENSETEN&NEA PRESSING"	"KY"	"Commonsense Ten and NEA"
"USSEN/KY CONWAY 2000 MEDICARE DEDUCTIBLE"	"KY"	
"USSEN/KY CONWAY AGAIN"	"KY"	
"USSEN/KY CONWAY CAUGHT"	"KY"	
"USSEN/KY CONWAY DARN GOOD"	"KY"	
"USSEN/KY CONWAY ENDORSE"	"KY"	
"USSEN/KY CONWAY FIGHTER"	"KY"	
"USSEN/KY CONWAY GETTING THINGS DONE"	"KY"	
"USSEN/KY CONWAY HE DOESNT KNOW US"	"KY"	
"USSEN/KY CONWAY HEROES"	"KY"	
"USSEN/KY CONWAY HURTING"	"KY"	
"USSEN/KY CONWAY INTERNET SAFETY"	"KY"	
"USSEN/KY CONWAY POCKETED"	"KY"	
"USSEN/KY CONWAY PUBLIC TROUGH"	"KY"	
"USSEN/KY CONWAY RIGHT"	"KY"	
"USSEN/KY CONWAY ROOTS"	"KY"	
"USSEN/KY CONWAY SOFT ON CRIME"	"KY"	
"USSEN/KY CONWAY THE GAME"	"KY"	
"USSEN/KY CONWAY TORN APART"	"KY"	
"USSEN/KY CONWAY WENDELL FORD ENDORSES"	"KY"	
"USSEN/KY CONWAY WHY"	"KY"	
"USSEN/KY CROSSROADSGPS OBAMACARE WRONG WAY"	"KY"	"Crossroads Grassroots Policy Strategies"
"USSEN/KY CROSSROADSGPS SHOCKER"	"KY"	"Crossroads Grassroots Policy Strategies"
"USSEN/KY CROSSROADSGPS WRONG WAY"	"KY"	"Crossroads Grassroots Policy Strategies"
"USSEN/KY CROSSROADSGPS YOU GUESSED IT"	"KY"	"Crossroads Grassroots Policy Strategies"
"USSEN/KY DSCC DEFINITELY"	"KY"	
"USSEN/KY DSCC NO RESPECT"	"KY"	
"USSEN/KY DSCC TWO THOUSAND DOLLARS"	"KY"	
"USSEN/KY FAA NO THANKS JACK"	"KY"	"First Amendment Alliance"
"USSEN/KY GRAYSON FED UP"	"KY"	
"USSEN/KY GRAYSON FIXING WASHINGTON"	"KY"	
"USSEN/KY GRAYSON IMPORTANT"	"KY"	
"USSEN/KY GRAYSON MCCONNELL ENDORSEMENT"	"KY"	
"USSEN/KY GRAYSON MCCONNELL ENDORSEMENT REV"	"KY"	
"USSEN/KY GRAYSON NORTHERN KENTUCKY"	"KY"	
"USSEN/KY GRAYSON PROBLEM"	"KY"	
"USSEN/KY GRAYSON STRANGE IDEAS"	"KY"	
"USSEN/KY GRAYSON THERE'S MORE"	"KY"	
"USSEN/KY KYDP THE RAND PAUL STOMP 60"	"KY"	
"USSEN/KY KYLC DRUG PUSHERS"	"KY"	"Kentucky Leadership Council"
"USSEN/KY MONGIARDO ANOTHER ONE"	"KY"	
"USSEN/KY MONGIARDO ANOTHER ONE REV"	"KY"	
"USSEN/KY MONGIARDO APPROVED 15"	"KY"	
"USSEN/KY MONGIARDO BANKROLLED"	"KY"	
"USSEN/KY MONGIARDO CHAMPION 15"	"KY"	
"USSEN/KY MONGIARDO COMMON SENSE 15"	"KY"	
"USSEN/KY MONGIARDO COMMON SENSE 15 REV"	"KY"	
"USSEN/KY MONGIARDO FIGHTING FOR US"	"KY"	
"USSEN/KY MONGIARDO HURTING 15"	"KY"	
"USSEN/KY MONGIARDO PRETENDING 15"	"KY"	
"USSEN/KY MONGIARDO SHOOTING BLANKS"	"KY"	
"USSEN/KY MOVEON THE COMPANY THEY KEEP"	"KY"	"MoveOn"
"USSEN/KY NRSC CHANGE THE SUBJECT"	"KY"	
"USSEN/KY NRSC FLIP FLOP JACK"	"KY"	
"USSEN/KY NRSC JOCKEY JACK"	"KY"	
"USSEN/KY NRSC SKYROCKET"	"KY"	
"USSEN/KY PAUL A DOCTOR I CAN TRUST"	"KY"	
"USSEN/KY PAUL CAP AND TRADE"	"KY"	
"USSEN/KY PAUL CAREER POLITICIANS"	"KY"	
"USSEN/KY PAUL CONDEMNED"	"KY"	
"USSEN/KY PAUL CONWAY'S STAMP OF APPROVAL"	"KY"	
"USSEN/KY PAUL FALSE WITNESS"	"KY"	
"USSEN/KY PAUL GIFT OF SIGHT"	"KY"	
"USSEN/KY PAUL HELPING HAND"	"KY"	
"USSEN/KY PAUL HONOR"	"KY"	
"USSEN/KY PAUL JIM BUNNING"	"KY"	
"USSEN/KY PAUL MACHINE"	"KY"	
"USSEN/KY PAUL MACHINE REV"	"KY"	
"USSEN/KY PAUL MY KIND OF MAN"	"KY"	
"USSEN/KY PAUL NATIONAL DEFENSE"	"KY"	
"USSEN/KY PAUL RAND'S PLAN"	"KY"	
"USSEN/KY PAUL RAND'S PROMISE"	"KY"	
"USSEN/KY PAUL SAVING SOC SEC AND MEDICARE"	"KY"	
"USSEN/KY PAUL SAVING SOC SEC AND MEDICARE REV"	"KY"	
"USSEN/KY PAUL STRONG NATIONAL DEFENSE"	"KY"	
"USSEN/KY PAUL STRONG NATIONAL DEFENSE REV"	"KY"	
"USSEN/KY PAUL TRUE CONSERVATIVE"	"KY"	
"USSEN/KY PAUL VALUES"	"KY"	
"USSEN/KY PAUL&NRSC OBAMA'S YES MAN"	"KY"	
"USSEN/KY SWEENEY I BELIEVE"	"KY"	
"USSEN/KY SWEENEY I BELIEVE REV"	"KY"	
"USSEN/KY SWEENEY WHAT IF"	"KY"	
"USSEN/KY USCOC STOP SIDING WITH PELOSI"	"KY"	"US Chamber of Commerce"
"USSEN/LA AFV BIG OIL VITTER"	"LA"	"American Family Voices"
"USSEN/LA HSLF DAVID VITTER"	"LA"	"Humane Society"
"USSEN/LA LADP&MELANCON FAITHFUL"	"LA"	
"USSEN/LA LADP&MELANCON SINS"	"LA"	
"USSEN/LA MELANCON DIFFERENCE"	"LA"	
"USSEN/LA MELANCON FORGOTTEN CRIMES"	"LA"	
"USSEN/LA MELANCON FORGOTTEN CRIMES 90"	"LA"	
"USSEN/LA MELANCON HONEST"	"LA"	
"USSEN/LA MELANCON INDEPENDENT"	"LA"	
"USSEN/LA MELANCON SINS"	"LA"	
"USSEN/LA MELANCON THE WORST"	"LA"	
"USSEN/LA MELANCON TOUGHER"	"LA"	
"USSEN/LA VITTER EXTRAVAGANT"	"LA"	
"USSEN/LA VITTER NO REGRETS"	"LA"	
"USSEN/LA VITTER OBAMA'S AGENDA"	"LA"	
"USSEN/LA VITTER ONE THOUSAND WORDS"	"LA"	
"USSEN/LA VITTER PARALLEL UNIVERSE"	"LA"	
"USSEN/LA VITTER PLANET WASHINGTON"	"LA"	
"USSEN/LA VITTER SNEAKERS"	"LA"	
"USSEN/LA VITTER WELCOME PRIZE"	"LA"	
"USSEN/MA AFF GET TAXES UP"	"MA"	"American Future Fund"
"USSEN/MA AFF ISSUES"	"MA"	"American Future Fund"
"USSEN/MA AJS AGREE"	"MA"	"Americans for Job Security"
"USSEN/MA ARHC BROWN PATIENTS RIGHTS"	"MA"	"Americans for Responsible Health Care"
"USSEN/MA ARHC RESPONSIBLE HEALTHCARE"	"MA"	"Americans for Responsible Health Care"
"USSEN/MA BROWN DAUGHTERS"	"MA"	
"USSEN/MA BROWN HEALTHCARE BILL"	"MA"	
"USSEN/MA BROWN HEY DAD"	"MA"	
"USSEN/MA BROWN LOBBYISTS"	"MA"	
"USSEN/MA BROWN MOMENTUM"	"MA"	
"USSEN/MA BROWN RESPONSE TO COAKLEY ATTACK AD"	"MA"	
"USSEN/MA BROWN SAME MESSAGE"	"MA"	
"USSEN/MA BROWN SAME MESSAGE REV"	"MA"	
"USSEN/MA C4SS BROWN THE SAME"	"MA"	"Citizens for Strength and Security"
"USSEN/MA COAKLEY ACCOUNTABLE"	"MA"	
"USSEN/MA COAKLEY ALMOST UNIMAGINABLE"	"MA"	
"USSEN/MA COAKLEY EVERY VOTE MATTERS"	"MA"	
"USSEN/MA COAKLEY LOCKSTEP REPUBLICAN"	"MA"	
"USSEN/MA COAKLEY NORTH ADAMS"	"MA"	
"USSEN/MA COAKLEY STAND UP"	"MA"	
"USSEN/MA COAKLEY TAKE US BACK"	"MA"	
"USSEN/MA COAKLEY WITH HER"	"MA"	
"USSEN/MA DSCC AGENDA"	"MA"	
"USSEN/MA DSCC UNDER THE HOOD"	"MA"	
"USSEN/MA LAV STOP OBAMA AGENDA"	"MA"	"League of American Voters"
"USSEN/MA LCV ENERGY JOBS"	"MA"	"League of Conservation Voters"
"USSEN/MA MADP LOCKSTEP REPUBLICAN"	"MA"	
"USSEN/MA NRTPAC END THE MADNESS"	"MA"	"National Republican Trust PAC"
"USSEN/MA OCDB TEA PARTY EXPRESS BROWN"	"MA"	"OUR COUNTRY DESERVES BETTER/ TEA PARTY EXPRESS"
"USSEN/MA SEIU MASSACHUSETTS VALUES"	"MA"	"SEIU"
"USSEN/MA SEIU MASSACHUSETTS VALUES REV"	"MA"	"SEIU"
"USSEN/MA USCOC BROWN FIX OUR ECONOMY"	"MA"	"US Chamber of Commerce"
"USSEN/MA USCOC TAX AND SPEND MORE"	"MA"	"US Chamber of Commerce"
"USSEN/MD MIKULSKI EDUCATION LOANS"	"MD"	
"USSEN/MD MIKULSKI FIRST JOB"	"MD"	
"USSEN/MD MIKULSKI METRO"	"MD"	
"USSEN/MD MIKULSKI PARTY"	"MD"	
"USSEN/MD MIKULSKI WOMEN"	"MD"	
"USSEN/MD WARGOTZ POLITICAL INSIDERSAURUS"	"MD"	
"USSEN/MD WARGOTZ THE WALL"	"MD"	
"USSEN/MO 7THDCRC CARNAHAN APPROVED"	"MO"	"7th District Republican Congressional Committee"
"USSEN/MO AMERICANCROSSROADS CONTINUES"	"MO"	"American Crossroads"
"USSEN/MO AMERICANCROSSROADS FOLLOWS"	"MO"	"American Crossroads"
"USSEN/MO AMERICANCROSSROADS WINDMILLS"	"MO"	"American Crossroads"
"USSEN/MO BLUNT BORDER SECURITY"	"MO"	
"USSEN/MO BLUNT CARNAHAN ON UNEMPLOYMENT"	"MO"	
"USSEN/MO BLUNT EDUCATION AND HARD WORK"	"MO"	
"USSEN/MO BLUNT INDEPENDENT VOICE"	"MO"	
"USSEN/MO BLUNT JOBS DIFFERENCE"	"MO"	
"USSEN/MO BLUNT MISSOURI'S FUTURE"	"MO"	
"USSEN/MO BLUNT PROTECTING MISSOURI"	"MO"	
"USSEN/MO BLUNT REAL VOICE FOR CHANGE"	"MO"	
"USSEN/MO BLUNT SMALL BUSINESS SUCCESS"	"MO"	
"USSEN/MO BLUNT WHO'S ROBIN CARNAHAN KIDDING"	"MO"	
"USSEN/MO CARNAHAN ANSWER"	"MO"	
"USSEN/MO CARNAHAN CARRY THE WATER"	"MO"	
"USSEN/MO CARNAHAN CAUGHT"	"MO"	
"USSEN/MO CARNAHAN CLEAN UP THE HOUSE"	"MO"	
"USSEN/MO CARNAHAN DAYS LATER"	"MO"	
"USSEN/MO CARNAHAN DIFFERENCES"	"MO"	
"USSEN/MO CARNAHAN DUSTBOWL"	"MO"	
"USSEN/MO CARNAHAN FOR MISSOURI"	"MO"	
"USSEN/MO CARNAHAN MANAGES"	"MO"	
"USSEN/MO CARNAHAN NINE YEARS LATER"	"MO"	
"USSEN/MO CARNAHAN POTATOES"	"MO"	
"USSEN/MO CARNAHAN SCARED STIFF"	"MO"	
"USSEN/MO CARNAHAN STRUGGLING"	"MO"	
"USSEN/MO COMMONSENSETEN SECRET"	"MO"	"Commonsense Ten"
"USSEN/MO CROSSROADSGPS CARNAHAN CARE"	"MO"	"Crossroads Grassroots Policy Strategies"
"USSEN/MO CROSSROADSGPS HEALTHCARE CARNAHAN"	"MO"	"Crossroads Grassroots Policy Strategies"
"USSEN/MO CROSSROADSGPS REVIEW"	"MO"	"Crossroads Grassroots Policy Strategies"
"USSEN/MO DSCC CULTURE OF CORRUPTION"	"MO"	
"USSEN/MO DSCC FAMILY"	"MO"	
"USSEN/MO DSCC HERE IN MISSOURI"	"MO"	
"USSEN/MO DSCC VERSUS"	"MO"	
"USSEN/MO LCV RIGHT FOR BIG OIL"	"MO"	"League of Conservation Voters"
"USSEN/MO NRA CARNAHAN WINS YOU LOSE"	"MO"	"NRA"
"USSEN/MO NRA ROY BLUNT"	"MO"	"NRA"
"USSEN/MO NRSC&BLUNT WHERE'S MY STIMULUS"	"MO"	
"USSEN/MO NRSC&BLUNT WRONG ON ISSUES"	"MO"	
"USSEN/MO USCOC BLUNT PLAN"	"MO"	"US Chamber of Commerce"
"USSEN/MO USCOC NOT CARD CHECK CARNAHAN"	"MO"	"US Chamber of Commerce"
"USSEN/MO VOTEKIDS BLUNT EXPOSED"	"MO"	"Vote Kids Action Fund"
"USSEN/MO VOTEVETS DANIEL ARRIGO"	"MO"	"VoteVets"
"USSEN/NC AMERUNTD BIG OIL BURR"	"NC"	"Americans United for Change"
"USSEN/NC BURKS CHANGE WASHINGTON 15"	"NC"	
"USSEN/NC BURKS MORTGAGE PAYMENT"	"NC"	
"USSEN/NC BURKS PROTECTING SECOND AMENDMENT"	"NC"	
"USSEN/NC BURKS READY FOR CHANGE 15"	"NC"	
"USSEN/NC BURKS RISING ENERGY COSTS"	"NC"	
"USSEN/NC BURR DISCONNECTED"	"NC"	
"USSEN/NC BURR FRONT PORCH"	"NC"	
"USSEN/NC BURR FUTURE"	"NC"	
"USSEN/NC BURR GENERATION"	"NC"	
"USSEN/NC BURR MAIN STREET"	"NC"	
"USSEN/NC BURR PRIORITIES"	"NC"	
"USSEN/NC BURR SERVING"	"NC"	
"USSEN/NC CUNNINGHAM BAD TRADE DEALS"	"NC"	
"USSEN/NC CUNNINGHAM DIFFERENT WAR"	"NC"	
"USSEN/NC MARSHALL GUTS"	"NC"	
"USSEN/NC MARSHALL THE DIFFERENCE"	"NC"	
"USSEN/NC MARSHALL THE DIFFERENCE REV"	"NC"	
"USSEN/NC MARSHALL THROW 'EM OUT"	"NC"	
"USSEN/NC MARSHALL THROW 'EM OUT REV"	"NC"	
"USSEN/NC REALJOBSNC TAX TWINS"	"NC"	"Real Jobs North Carolina"
"USSEN/ND HOEVEN BACK ON TRACK"	"ND"	
"USSEN/ND HOEVEN COMMON SENSE"	"ND"	
"USSEN/ND HOEVEN COMMON SENSE REV"	"ND"	
"USSEN/ND HOEVEN ENERGIZING OUR NATION"	"ND"	
"USSEN/ND HOEVEN FUTURE GENERATIONS"	"ND"	
"USSEN/ND HOEVEN JOBS FOR THE FUTURE"	"ND"	
"USSEN/ND HOEVEN KARI AND RYAN WEIGEL"	"ND"	
"USSEN/ND HOEVEN MAYORS"	"ND"	
"USSEN/ND HOEVEN MILITARY FAMILIES"	"ND"	
"USSEN/ND HOEVEN SENIORS"	"ND"	
"USSEN/ND HOEVEN SENIORS REV"	"ND"	
"USSEN/ND HOEVEN STRONG CARING LEADER"	"ND"	
"USSEN/ND HOEVEN TAKING CARE OF SENIORS"	"ND"	
"USSEN/ND HOEVEN WE NEED HIM"	"ND"	
"USSEN/ND NDD CHOOSE POTTER"	"ND"	
"USSEN/ND NDD KNOW"	"ND"	"unknown"
"USSEN/ND NDD POTTER EXPERIENCE"	"ND"	
"USSEN/NE VOTEKIDS AMANDA MCKINNEY NELSON"	"NE"	"VoteKids.org"
"USSEN/NH AAN A PROMISE"	"NH"	"American Action Network"
"USSEN/NH AAN COLD"	"NH"	"American Action Network"
"USSEN/NH AMERICANCROSSROADS FISCAL"	"NH"	"American Crossroads"
"USSEN/NH AYOTTE CONSERVATIVE"	"NH"	
"USSEN/NH AYOTTE FALSE"	"NH"	
"USSEN/NH AYOTTE HUMOR"	"NH"	
"USSEN/NH AYOTTE LIBERAL"	"NH"	
"USSEN/NH AYOTTE MY FAMILY"	"NH"	
"USSEN/NH AYOTTE NEVER BACKED DOWN"	"NH"	
"USSEN/NH AYOTTE NEVER BACKED DOWN 60"	"NH"	
"USSEN/NH AYOTTE PATHS"	"NH"	
"USSEN/NH AYOTTE RUNNING"	"NH"	
"USSEN/NH AYOTTE SIMPLE TRUTHS"	"NH"	
"USSEN/NH AYOTTE STOP"	"NH"	
"USSEN/NH AYOTTE TAXING"	"NH"	
"USSEN/NH AYOTTE TOUGH DECISIONS"	"NH"	
"USSEN/NH AYOTTE&NRSC HUMOR"	"NH"	
"USSEN/NH AYOTTE&NRSC PATHS"	"NH"	
"USSEN/NH BENDER CHANGE WASHINGTON"	"NH"	
"USSEN/NH BENDER FIX GOVERNMENT"	"NH"	
"USSEN/NH BENDER JIM FOR JOBS"	"NH"	
"USSEN/NH BENDER JIM FOR JOBS 2"	"NH"	
"USSEN/NH BENDER JOY RIDE"	"NH"	
"USSEN/NH BENDER PUBLIC SERVANT"	"NH"	
"USSEN/NH BENDER TERM LIMITS"	"NH"	
"USSEN/NH BENDER YUM YUM"	"NH"	
"USSEN/NH BINNIE BACK ON TRACK"	"NH"	
"USSEN/NH BINNIE BARBERSHOP"	"NH"	
"USSEN/NH BINNIE BIO"	"NH"	
"USSEN/NH BINNIE BOB CLEGG"	"NH"	
"USSEN/NH BINNIE BUSINESSMAN 15"	"NH"	
"USSEN/NH BINNIE CAMPAIGN GROWING"	"NH"	
"USSEN/NH BINNIE CONSERVATIVE"	"NH"	
"USSEN/NH BINNIE ENGLISH"	"NH"	
"USSEN/NH BINNIE FACT"	"NH"	
"USSEN/NH BINNIE FED UP"	"NH"	
"USSEN/NH BINNIE HELP WANTED"	"NH"	
"USSEN/NH BINNIE INSIDER"	"NH"	
"USSEN/NH BINNIE INSIDER REV"	"NH"	
"USSEN/NH BINNIE INTRODUCTION"	"NH"	
"USSEN/NH BINNIE JOBS"	"NH"	
"USSEN/NH BINNIE JOBS 15"	"NH"	
"USSEN/NH BINNIE ON THE BRINK"	"NH"	
"USSEN/NH BINNIE ON THE TRAIL"	"NH"	
"USSEN/NH BINNIE OUR ECONOMY"	"NH"	
"USSEN/NH BINNIE RONNIE BEAN"	"NH"	
"USSEN/NH BINNIE SUPPORTERS"	"NH"	
"USSEN/NH BINNIE VICTIMS"	"NH"	
"USSEN/NH CA&NOM SHOCKINGLY LIBERAL"	"NH"	"Cornerstone Action and the National Organization for Marriage"
"USSEN/NH HODES 44 TIMES"	"NH"	
"USSEN/NH HODES GO FROM HERE"	"NH"	
"USSEN/NH HODES HOTDOG"	"NH"	
"USSEN/NH HODES IN THIS TOGETHER"	"NH"	
"USSEN/NH HODES LOOK AROUND"	"NH"	
"USSEN/NH HODES ONCE"	"NH"	
"USSEN/NH HODES TRUST"	"NH"	
"USSEN/NH LAMONTAGNE THE OATH"	"NH"	
"USSEN/NH USCOC HODES SPENDING"	"NH"	"US Chamber of Commerce"
"USSEN/NH USCOC LIBERAL EXPRESS"	"NH"	"US Chamber of Commerce"
"USSEN/NV ABRC&FAMILIESUSA GOOD JOBS REID"	"NV"	"Families USA and America's Biopharmaceutical Companies"
"USSEN/NV AFSCME TOO DANGEROUS"	"NV"	"AFSCME"
"USSEN/NV AMERICANCROSSROADS HIGHEST"	"NV"	"American Crossroads"
"USSEN/NV AMERICANCROSSROADS NOT MY JOB"	"NV"	"American Crossroads"
"USSEN/NV AMERICANCROSSROADS PAYING OFF"	"NV"	"American Crossroads"
"USSEN/NV AMERICANCROSSROADS REALLY"	"NV"	"American Crossroads"
"USSEN/NV AMERICANCROSSROADS REALLY REV"	"NV"	"American Crossroads"
"USSEN/NV ANGLE 300"	"NV"	
"USSEN/NV ANGLE AT YOUR EXPENSE"	"NV"	
"USSEN/NV ANGLE BEST FRIEND"	"NV"	
"USSEN/NV ANGLE BIG CLUE"	"NV"	
"USSEN/NV ANGLE BIG COALITION"	"NV"	
"USSEN/NV ANGLE CONSERVATIVE CHAMPION"	"NV"	
"USSEN/NV ANGLE FACES"	"NV"	
"USSEN/NV ANGLE FRIENDS SUPPORT"	"NV"	
"USSEN/NV ANGLE HARRY VS YOU"	"NV"	
"USSEN/NV ANGLE LOVE STORY"	"NV"	
"USSEN/NV ANGLE NOW"	"NV"	
"USSEN/NV ANGLE NOW 60"	"NV"	
"USSEN/NV ANGLE ONE TRUE CONSERVATIVE"	"NV"	
"USSEN/NV ANGLE OUR TURN"	"NV"	
"USSEN/NV ANGLE PLEASE STOP"	"NV"	
"USSEN/NV ANGLE PROPERTY VALUES"	"NV"	
"USSEN/NV ANGLE PUBLIC SERVANT"	"NV"	
"USSEN/NV ANGLE REAL WORLD"	"NV"	
"USSEN/NV ANGLE RIGHT HERE RIGHT NOW"	"NV"	
"USSEN/NV ANGLE SOCIAL SECURITY"	"NV"	
"USSEN/NV ANGLE STUPID THINGS HARRY SAYS"	"NV"	
"USSEN/NV ANGLE THANKS PAL"	"NV"	
"USSEN/NV ANGLE THE WAVE"	"NV"	
"USSEN/NV ANGLE WON EVERY DEBATE"	"NV"	
"USSEN/NV ANGLE&NRSC PUBLIC SERVANT"	"NV"	
"USSEN/NV ANL SOCIAL SECURITY"	"NV"	"Americans for New Leadership"
"USSEN/NV ANL WRONG"	"NV"	"Americans for New Leadership"
"USSEN/NV BERNSTEIN JOANNA GARNEAU"	"NV"	
"USSEN/NV CFG BEST CHOICE"	"NV"	"Club for Growth"
"USSEN/NV CFG ENOUGH"	"NV"	"Club for Growth"
"USSEN/NV CFL STEALING OUR LIBERTY"	"NV"	"Campaign for Liberty"
"USSEN/NV CHACHAS DEEP ROOTS"	"NV"	
"USSEN/NV CHACHAS ELEPHANT"	"NV"	
"USSEN/NV CHACHAS TURN THE LIGHTS BACK ON"	"NV"	
"USSEN/NV CHACHAS WASHINGTON BUDGET CUTS 60"	"NV"	
"USSEN/NV CITZLINK&SBALIST INSIDERS"	"NV"	"CITIZEN LINK, SUSAN B. ANTHONY LIST"
"USSEN/NV CROSSROADSGPS ENOUGH"	"NV"	"Crossroads Grassroots Policy Strategies"
"USSEN/NV CROSSROADSGPS HAD HIS CHANCE"	"NV"	"Crossroads Grassroots Policy Strategies"
"USSEN/NV CROSSROADSGPS OBAMACARE"	"NV"	"Crossroads Grassroots Policy Strategies"
"USSEN/NV CROSSROADSGPS STIMULUS"	"NV"	"Crossroads Grassroots Policy Strategies"
"USSEN/NV CROSSROADSGPS STORY"	"NV"	"Crossroads Grassroots Policy Strategies"
"USSEN/NV CU A BETTER FUTURE"	"NV"	"Citizens United"
"USSEN/NV CU SOCIAL SECURITY"	"NV"	"Citizens United"
"USSEN/NV CWF STAGGERING"	"NV"	"Campaign for Working Families"
"USSEN/NV DSCC BOXER"	"NV"	
"USSEN/NV DSCC TWO CANDIDATES"	"NV"	
"USSEN/NV ECONOMYFORWARD POINT FINGERS 60"	"NV"	"Economy Forward"
"USSEN/NV ESF EARMARK"	"NV"	"Ending Spending Fund"
"USSEN/NV FAA CLEAR MESSAGE"	"NV"	"First Amendment Alliance"
"USSEN/NV GUNDLACH FRANK MIR"	"NV"	
"USSEN/NV HAINES MAKE HISTORY"	"NV"	
"USSEN/NV LEGACYPAC&RMC GAMING LICENSE"	"NV"	"Legacy PAC and the Republican Majority Campaign"
"USSEN/NV LETFREEDOMRING ABUSIVE"	"NV"	"Let Freedom Ring"
"USSEN/NV LETFREEDOMRING DIRTY HARRY"	"NV"	"Let Freedom Ring"
"USSEN/NV LETFREEDOMRING NOBEL PRIZE"	"NV"	"Let Freedom Ring"
"USSEN/NV LETFREEDOMRING UNEMPLOYMENT"	"NV"	"Let Freedom Ring"
"USSEN/NV LOWDEN AGAINST"	"NV"	
"USSEN/NV LOWDEN BOYS WILL BE BOYS"	"NV"	
"USSEN/NV LOWDEN BUILDING OUR COUNTRY"	"NV"	
"USSEN/NV LOWDEN CREATING OPPORTUNITY"	"NV"	
"USSEN/NV LOWDEN INVEST AND INNOVATE"	"NV"	
"USSEN/NV LOWDEN LEADING WITH INTEGRITY"	"NV"	
"USSEN/NV LOWDEN ONE-SIZE FITS ALL"	"NV"	
"USSEN/NV LOWDEN PRISON SPA"	"NV"	
"USSEN/NV LOWDEN READ MY RECORD"	"NV"	
"USSEN/NV LOWDEN TERRIFIED"	"NV"	
"USSEN/NV LOWDEN THEY WANT MORE"	"NV"	
"USSEN/NV NNUPP WRONG ANGLE EDUCATION 15"	"NV"	"Nurses United for Patient Protection"
"USSEN/NV NNUPP WRONG ANGLE FAMILIES 15"	"NV"	"Nurses United for Patient Protection"
"USSEN/NV NNUPP WRONG ANGLE JOBS 15"	"NV"	"Nurses United for Patient Protection"
"USSEN/NV NNUPP WRONG ANGLE MEDICARE 15"	"NV"	"Nurses United for Patient Protection"
"USSEN/NV NRSC RITZ"	"NV"	
"USSEN/NV NRWC FORCED UNIONISM 60"	"NV"	"National Right to Work Committee"
"USSEN/NV OCDB ANGLE CONSERVATIVE CHOICE"	"NV"	"OUR COUNTRY DESERVES BETTER/ TEA PARTY EXPRESS"
"USSEN/NV OCDB ANGLE CONSERVATIVE REPUBLICAN"	"NV"	"OUR COUNTRY DESERVES BETTER/ TEA PARTY EXPRESS"
"USSEN/NV OCDB HAND REID PINK SLIP"	"NV"	"OUR COUNTRY DESERVES BETTER/ TEA PARTY EXPRESS"
"USSEN/NV OCDB HAND REID PINK SLIP 60"	"NV"	"OUR COUNTRY DESERVES BETTER/ TEA PARTY EXPRESS"
"USSEN/NV OCDB SHOWDOWN IN SEARCHLIGHT 60"	"NV"	"OUR COUNTRY DESERVES BETTER/ TEA PARTY EXPRESS"
"USSEN/NV OCDB SKYROCKETED 60"	"NV"	"OUR COUNTRY DESERVES BETTER/ TEA PARTY EXPRESS"
"USSEN/NV OCDB WE THE PEOPLE"	"NV"	"OUR COUNTRY DESERVES BETTER/ TEA PARTY EXPRESS"
"USSEN/NV PAF LOWDEN FIGHTING PAY RAISES"	"NV"	"Partnership for America's Future"
"USSEN/NV PATRIOT ANOTHER BAD IDEA"	"NV"	"Patriot Majority"
"USSEN/NV PATRIOT CHICKENS FOR CHECKUPS 2"	"NV"	"Patriot Majority"
"USSEN/NV PATRIOT CHILE"	"NV"	"Patriot Majority"
"USSEN/NV PATRIOT DON'T PRIVATIZE THE VA"	"NV"	"Patriot Majority"
"USSEN/NV PATRIOT EVERY FOUR MINUTES"	"NV"	"Patriot Majority"
"USSEN/NV PATRIOT HOW'S THAT"	"NV"	"Patriot Majority"
"USSEN/NV PATRIOT LISTEN TO SHARRON SP"	"NV"	"Patriot Majority"
"USSEN/NV PATRIOT LOWDEN CHICKENS FOR CHECKUPS"	"NV"	"Patriot Majority"
"USSEN/NV PATRIOT NOT HER JOB"	"NV"	"Patriot Majority"
"USSEN/NV PATRIOT OUT OF TOUCH"	"NV"	"Patriot Majority"
"USSEN/NV PATRIOT PENNY"	"NV"	"Patriot Majority"
"USSEN/NV PATRIOT TOO DANGEROUS"	"NV"	"Patriot Majority"
"USSEN/NV PATRIOT TOUGH LUCK"	"NV"	"Patriot Majority"
"USSEN/NV PATRIOT VERY OUT OF TOUCH"	"NV"	"Patriot Majority"
"USSEN/NV PATRIOT VETS AGAINST ANGLE"	"NV"	"Patriot Majority"
"USSEN/NV PATRIOT VOTE AGAINST ANGLE SP"	"NV"	"Patriot Majority"
"USSEN/NV PATRIOT WHAT DO YOU THINK"	"NV"	"Patriot Majority"
"USSEN/NV REID 400 MILES"	"NV"	
"USSEN/NV REID A BETTER CHOICE NORTHERN"	"NV"	
"USSEN/NV REID A BETTER CHOICE SOUTHERN"	"NV"	
"USSEN/NV REID A FOREIGN WORKER'S FRIEND"	"NV"	
"USSEN/NV REID ALWAYS STOOD WITH US SP"	"NV"	
"USSEN/NV REID BACKGROUND CHECKS"	"NV"	
"USSEN/NV REID BP 20B ESCROW ACCOUNT FOR GULF"	"NV"	
"USSEN/NV REID BROKEN PROMISE"	"NV"	
"USSEN/NV REID CITY CENTER"	"NV"	
"USSEN/NV REID DEBRA HARDING"	"NV"	
"USSEN/NV REID DOMESTIC VIOLENCE"	"NV"	
"USSEN/NV REID EDUCATION AGENDA"	"NV"	
"USSEN/NV REID EDUCATION SP"	"NV"	
"USSEN/NV REID EXTREME"	"NV"	
"USSEN/NV REID EXTREME HYPOCRISY"	"NV"	
"USSEN/NV REID GARLAND WELCH"	"NV"	
"USSEN/NV REID GEOTHERMAL"	"NV"	
"USSEN/NV REID I DON'T THINK SO"	"NV"	
"USSEN/NV REID IT'S NOT MY JOB SP"	"NV"	
"USSEN/NV REID KATHERINE DUNCAN"	"NV"	
"USSEN/NV REID KIDDING"	"NV"	
"USSEN/NV REID LINDA ELLEN"	"NV"	
"USSEN/NV REID MORE THAN WRONG"	"NV"	
"USSEN/NV REID RESPOND TO ANGLE SP"	"NV"	
"USSEN/NV REID RON NELSON"	"NV"	
"USSEN/NV REID SHARRON ANGLE JUST TOO EXTREME"	"NV"	
"USSEN/NV REID SHARRON ANGLE'S NEVADA"	"NV"	
"USSEN/NV REID SOLAR"	"NV"	
"USSEN/NV REID STAYING IN BUSINESS"	"NV"	
"USSEN/NV REID WE ARE CITIZENS SP"	"NV"	
"USSEN/NV REID WELFARE"	"NV"	
"USSEN/NV REID WHAT'S NEXT"	"NV"	
"USSEN/NV REID WILD"	"NV"	
"USSEN/NV REID WORKS FOR NEVADA VETERANS"	"NV"	
"USSEN/NV REID WORSE"	"NV"	
"USSEN/NV REID YUCCA"	"NV"	
"USSEN/NV SEIU PHASES"	"NV"	"SEIU"
"USSEN/NV SHP OVER THE EDGE"	"NV"	"Send Harry Packing"
"USSEN/NV STABLEQUALITYCARE STRUGGLE REID"	"NV"	"Americans for Stable Quality Care"
"USSEN/NV TARKANIAN ATTACKING EACH OTHER"	"NV"	
"USSEN/NV TARKANIAN INSIDERS GAME"	"NV"	
"USSEN/NV TARKANIAN NEVADA VALUES"	"NV"	
"USSEN/NV TARKANIAN POWER AND MONEY"	"NV"	
"USSEN/NV TARKANIAN REMOVE INCENTIVES"	"NV"	
"USSEN/NV VOTEVETS HIGHWAY 90"	"NV"	"VoteVets"
"USSEN/NY DIOGUARDI BURNED AMERICA"	"NY"	
"USSEN/NY DIOGUARDI CREDIT CARD"	"NY"	
"USSEN/NY DIOGUARDI THE AMERICAN DREAM"	"NY"	
"USSEN/NY GILLIBRAND FIGHTING"	"NY"	
"USSEN/NY GILLIBRAND MADE IN AMERICA"	"NY"	
"USSEN/NY GILLIBRAND NEWSPAPERS ENDORSE"	"NY"	
"USSEN/NY GILLIBRAND NEWSPAPERS ENDORSE REV"	"NY"	
"USSEN/NY GILLIBRAND OPEN"	"NY"	
"USSEN/NY GILLIBRAND REVOLUTION"	"NY"	
"USSEN/NY GILLIBRAND TURNING"	"NY"	
"USSEN/NY GILLIBRAND WHO IS JOE DIOGUARDI"	"NY"	
"USSEN/NY MALPASS CLEAR CHOICE"	"NY"	
"USSEN/NY MALPASS RECKLESS"	"NY"	
"USSEN/NY MALPASS RUDY"	"NY"	
"USSEN/NY SCHUMER COMMUTERS"	"NY"	
"USSEN/NY SCHUMER FAMILY"	"NY"	
"USSEN/NY SCHUMER FLOOD"	"NY"	
"USSEN/NY SCHUMER GAVE US BACK"	"NY"	
"USSEN/NY SCHUMER MADE IN AMERICA"	"NY"	
"USSEN/NY SCHUMER MIDDLE CLASS"	"NY"	
"USSEN/NY SCHUMER OTHER PEOPLE'S TRASH"	"NY"	
"USSEN/NY SCHUMER THE CALL 60"	"NY"	
"USSEN/OH AMERICANCROSSROADS BEHIND"	"OH"	"American Crossroads"
"USSEN/OH AMERICANCROSSROADS JOBS FOR OHIO"	"OH"	"American Crossroads"
"USSEN/OH FISHER BETRAYAL"	"OH"	
"USSEN/OH FISHER ECONOMIC PLAN"	"OH"	
"USSEN/OH FISHER GAME DAY"	"OH"	
"USSEN/OH FISHER PROUD"	"OH"	
"USSEN/OH FISHER THRIFT AND HARD WORK"	"OH"	
"USSEN/OH GANLEY MORNING 60"	"OH"	
"USSEN/OH NRA ROB PORTMAN"	"OH"	"NRA"
"USSEN/OH PORTMAN BLIND DATE"	"OH"	
"USSEN/OH PORTMAN FUTURE GENERATIONS"	"OH"	
"USSEN/OH PORTMAN FUTURE GENERATIONS REV"	"OH"	
"USSEN/OH PORTMAN JOB KILLER ENERGY TAX"	"OH"	
"USSEN/OH PORTMAN JOBS CZAR"	"OH"	
"USSEN/OH PORTMAN JOBS FAIR"	"OH"	
"USSEN/OH PORTMAN JOBS PLAN"	"OH"	
"USSEN/OH PORTMAN JOBS PLAN 2"	"OH"	
"USSEN/OH PORTMAN JOBS PLAN 2 REV"	"OH"	
"USSEN/OH PORTMAN STILL AT IT"	"OH"	
"USSEN/OH PORTMAN TIMELINE"	"OH"	
"USSEN/OH PORTMAN WITHIN MEANS"	"OH"	
"USSEN/OH PORTMAN&NRSC TIMELINE"	"OH"	
"USSEN/OK COBURN DOWNSIZING FEDERAL GOVERNMENT"	"OK"	
"USSEN/OK COBURN FUTURE GENERATIONS"	"OK"	
"USSEN/OR HUFFMAN OUR VOICE"	"OR"	
"USSEN/OR HUFFMAN OUT OF TOUCH"	"OR"	
"USSEN/OR WYDEN A LITTLE DIFFERENT"	"OR"	
"USSEN/OR WYDEN BIG THINGS"	"OR"	
"USSEN/OR WYDEN COMEBACK"	"OR"	
"USSEN/OR WYDEN EVERY DOLLAR"	"OR"	
"USSEN/OR WYDEN OREGON BORN"	"OR"	
"USSEN/OR WYDEN OREGONIANS"	"OR"	
"USSEN/OR WYDEN RESPECT"	"OR"	
"USSEN/PA AFLCIO AMERICAN PATRIOT 10"	"PA"	"AFL-CIO"
"USSEN/PA ATR JOE TO GO"	"PA"	"Americans for Tax Reform"
"USSEN/PA ATR MAKE IT WORSE"	"PA"	"Americans for Tax Reform"
"USSEN/PA CFG IT'S VERY LIBERAL"	"PA"	"Club for Growth"
"USSEN/PA CFG NAVY"	"PA"	"Club for Growth"
"USSEN/PA CFG SOCKS"	"PA"	"Club for Growth"
"USSEN/PA CROSSROADSGPS ADD UP"	"PA"	"Crossroads Grassroots Policy Strategies"
"USSEN/PA CROSSROADSGPS HURTING FOR CERTAIN"	"PA"	"Crossroads Grassroots Policy Strategies"
"USSEN/PA CROSSROADSGPS WHAT"	"PA"	"Crossroads Grassroots Policy Strategies"
"USSEN/PA CWF STAGGERING"	"PA"	"Campaign for Working Families"
"USSEN/PA DSCC BETHLEHEM STEEL"	"PA"	
"USSEN/PA DSCC BETHLEHEM STEEL REV"	"PA"	
"USSEN/PA DSCC CORNING"	"PA"	
"USSEN/PA DSCC DEALER"	"PA"	
"USSEN/PA DSCC LOVE"	"PA"	
"USSEN/PA DSCC MOVED"	"PA"	
"USSEN/PA DSCC OUTSOURCING"	"PA"	
"USSEN/PA DSCC REAL DEAL"	"PA"	
"USSEN/PA DSCC TOOMEY MR WALL STREET"	"PA"	
"USSEN/PA DSCC WORK EVERY DAY"	"PA"	
"USSEN/PA DSCC WORK EVERY DAY 3"	"PA"	
"USSEN/PA DSCC WORK EVERY DAY REV"	"PA"	
"USSEN/PA ECIP SESTAK'S RECORD"	"PA"	"unknown"
"USSEN/PA JSTREET PRO-ISRAEL RECORD"	"PA"	"J Street"
"USSEN/PA NRA SESTAK WINS YOU LOSE"	"PA"	"NRA"
"USSEN/PA NRSC INTERVIEW"	"PA"	
"USSEN/PA NRSC STATUS QUO JOE"	"PA"	
"USSEN/PA NRSC&TOOMEY RESTAURANT"	"PA"	
"USSEN/PA NRSC&TOOMEY SAY IT AINT SO JOE"	"PA"	
"USSEN/PA NRWC WAFFLING SPECTER 60"	"PA"	"National Right to Work Committee"
"USSEN/PA RJC TERRORIST TRIALS"	"PA"	"Republican Jewish Coalition"
"USSEN/PA SESTAK BELLE"	"PA"	
"USSEN/PA SESTAK DEAD HEAT"	"PA"	
"USSEN/PA SESTAK DOESN'T GET IT"	"PA"	
"USSEN/PA SESTAK ENDORSEMENTS"	"PA"	
"USSEN/PA SESTAK ENDORSEMENTS REV"	"PA"	
"USSEN/PA SESTAK INDEPENDENT VOICE"	"PA"	
"USSEN/PA SESTAK LEADING"	"PA"	
"USSEN/PA SESTAK MEET JOE 60"	"PA"	
"USSEN/PA SESTAK NOT ON OUR SIDE"	"PA"	
"USSEN/PA SESTAK SAVE ONE JOB"	"PA"	
"USSEN/PA SESTAK SECURITY"	"PA"	
"USSEN/PA SESTAK SENIORS SPEAK OUT"	"PA"	
"USSEN/PA SESTAK THE DIFFERENCE"	"PA"	
"USSEN/PA SESTAK TIMELINE"	"PA"	
"USSEN/PA SESTAK VETERANS SPEAK OUT"	"PA"	
"USSEN/PA SESTAK ZERO"	"PA"	
"USSEN/PA SPECTER ATTENDANCE RECORD 15"	"PA"	
"USSEN/PA SPECTER BETHLEHEM STEEL"	"PA"	
"USSEN/PA SPECTER BETHLEHEM STEEL REV"	"PA"	
"USSEN/PA SPECTER BETHLEHEM STEEL REV 2"	"PA"	
"USSEN/PA SPECTER MINIMUM WAGE"	"PA"	
"USSEN/PA SPECTER MINIMUM WAGE 15"	"PA"	
"USSEN/PA SPECTER NORTHEAST BUILDING PRODUCTS"	"PA"	
"USSEN/PA SPECTER REAL DEAL"	"PA"	
"USSEN/PA SPECTER SESTAK MISSED VOTES"	"PA"	
"USSEN/PA SPECTER WORKING PEOPLE"	"PA"	
"USSEN/PA TOOMEY BAILOUT"	"PA"	
"USSEN/PA TOOMEY BAILOUT 15"	"PA"	
"USSEN/PA TOOMEY CAP AND TRADE 15"	"PA"	
"USSEN/PA TOOMEY CAP AND TRADE 15 REV"	"PA"	
"USSEN/PA TOOMEY CLEAR CHOICE"	"PA"	
"USSEN/PA TOOMEY DEATH TAX 15"	"PA"	
"USSEN/PA TOOMEY DIFFERENT PLAN"	"PA"	
"USSEN/PA TOOMEY DOCTOR"	"PA"	
"USSEN/PA TOOMEY EXTREME SPENDING 15"	"PA"	
"USSEN/PA TOOMEY FOCUS"	"PA"	
"USSEN/PA TOOMEY GENERATIONS"	"PA"	
"USSEN/PA TOOMEY GENERATIONS REV"	"PA"	
"USSEN/PA TOOMEY LAST YEAR 15"	"PA"	
"USSEN/PA TOOMEY LIBERAL HEALTHCARE 15"	"PA"	
"USSEN/PA TOOMEY LIFELONG DEMOCRAT"	"PA"	
"USSEN/PA TOOMEY STANDS UP FOR JOBS"	"PA"	
"USSEN/PA TOOMEY STANDS UP FOR JOBS REV"	"PA"	
"USSEN/PA TOOMEY STIMULUS BILL 15"	"PA"	
"USSEN/PA TOOMEY STRONGEST ALLY"	"PA"	
"USSEN/PA USCOC 100 PERCENT PELOSI"	"PA"	"US Chamber of Commerce"
"USSEN/PA USCOC LOOK AT THE FACTS"	"PA"	"US Chamber of Commerce"
"USSEN/PA USCOC NOT CARD CHECK SESTAK"	"PA"	"US Chamber of Commerce"
"USSEN/PA USCOC SESTAK 100 PERCENT"	"PA"	"US Chamber of Commerce"
"USSEN/PA VOTEVETS EXPECTED BETTER TOOMEY"	"PA"	"VoteVets"
"USSEN/SC CLEMENTS EXTREMIST CANDIDATES"	"SC"	
"USSEN/SC CLEMENTS HARMFUL VISION"	"SC"	
"USSEN/SC CLEMENTS WHAT HAS HE DONE"	"SC"	
"USSEN/UT BENNETT CAN'T AFFORD TO LOSE 60"	"UT"	
"USSEN/UT BENNETT CLUB FOR GROWTH RESPONSE 60"	"UT"	
"USSEN/UT BENNETT NATIONAL SECURITY 60"	"UT"	
"USSEN/UT BENNETT WAR ON TERROR"	"UT"	
"USSEN/UT BRIDGEWATER STOP THE INSANITY"	"UT"	
"USSEN/UT BRUNSON IT'S THE LAW"	"UT"	
"USSEN/UT GRANATO MAC CHRISTENSEN"	"UT"	
"USSEN/UT LEE GREAT IDEA"	"UT"	
"USSEN/UT LEE STOP LIBERAL AGENDA"	"UT"	
"USSEN/UT LEE THE CONSERVATIVE WE CAN TRUST"	"UT"	
"USSEN/VT BRITTON CLAY DANIELS OVAL"	"VT"	
"USSEN/VT BRITTON ECONOMY IN SHAMBLES"	"VT"	
"USSEN/VT BRITTON GET A PAPER ROUTE BILLY 60"	"VT"	
"USSEN/VT LEAHY AUGUST IN VERMONT"	"VT"	
"USSEN/VT LEAHY DUET"	"VT"	
"USSEN/VT LEAHY REFLECTIONS"	"VT"	
"USSEN/VT LEAHY ROGER MARCOUX"	"VT"	
"USSEN/VT LEAHY SAFE RETURN"	"VT"	
"USSEN/VT VTRFEC&BRITTON AT HOME WITH LEN"	"VT"	
"USSEN/VT VTRFEC&BRITTON BAIL FASTER BILLY"	"VT"	
"USSEN/VT VTRFEC&BRITTON PAPER ROUTE BILLY 60"	"VT"	
"USSEN/WA AAN MAKE MURRAY WORRY"	"WA"	"American Action Network"
"USSEN/WA AAN OUCH"	"WA"	"American Action Network"
"USSEN/WA AFSCME&COMMONSENSETEN PERPETUAL"	"WA"	"AFSCME and Commonsense Ten"
"USSEN/WA AKERS HIGHWAY SIGN"	"WA"	
"USSEN/WA AKERS NOT A CAREER POLITICIAN"	"WA"	
"USSEN/WA AKERS NOT POLITICS AS USUAL"	"WA"	
"USSEN/WA AKERS PEOPLE ARE WORRIED"	"WA"	
"USSEN/WA BENTON VIAGRA FOR SEX OFFENDERS"	"WA"	
"USSEN/WA C4SS JOBS"	"WA"	"Citizens for Strength and Security"
"USSEN/WA C4SS SMALL BUSINESS MURRAY"	"WA"	"Citizens for Strength and Security"
"USSEN/WA CFTIP HELPING THE WRONG WASHINGTON"	"WA"	"Committee for Truth in Politics"
"USSEN/WA COMMONSENSETEN FLEAS"	"WA"	"Commonsense Ten"
"USSEN/WA COMMONSENSETEN PERPETUAL"	"WA"	"Commonsense Ten"
"USSEN/WA CROSSROADSGPS CAN'T AFFORD PATTY"	"WA"	"Crossroads Grassroots Policy Strategies"
"USSEN/WA CROSSROADSGPS PATTY'S PROMISES"	"WA"	"Crossroads Grassroots Policy Strategies"
"USSEN/WA CROSSROADSGPS PROBLEM WITH PATTY"	"WA"	"Crossroads Grassroots Policy Strategies"
"USSEN/WA DSCC FOR US"	"WA"	
"USSEN/WA DSCC JOB OUT EAST"	"WA"	
"USSEN/WA DSCC TRUST"	"WA"	
"USSEN/WA DSCC WHY"	"WA"	
"USSEN/WA MURRAY AIRBUS"	"WA"	
"USSEN/WA MURRAY AMERICAN JOBS"	"WA"	
"USSEN/WA MURRAY BEST FRIENDS"	"WA"	
"USSEN/WA MURRAY BOEING"	"WA"	
"USSEN/WA MURRAY COMPARE"	"WA"	
"USSEN/WA MURRAY EASTERN WASHINGTON"	"WA"	
"USSEN/WA MURRAY EIGHTEEN YEARS"	"WA"	
"USSEN/WA MURRAY FOR HIMSELF"	"WA"	
"USSEN/WA MURRAY GAMBLING"	"WA"	
"USSEN/WA MURRAY MIDDLE CLASS"	"WA"	
"USSEN/WA MURRAY NEVER FORGOTTEN"	"WA"	
"USSEN/WA MURRAY NO WONDER"	"WA"	
"USSEN/WA MURRAY REPEAL"	"WA"	
"USSEN/WA MURRAY SERVICE AND SACRIFICE 60"	"WA"	
"USSEN/WA MURRAY SOUTHWEST WASHINGTON"	"WA"	
"USSEN/WA MURRAY TRUST"	"WA"	
"USSEN/WA MURRAY WENATCHEE"	"WA"	
"USSEN/WA MURRAY YOUR VOICE"	"WA"	
"USSEN/WA MURRAY YOUR VOICE REV"	"WA"	
"USSEN/WA NEA&COMMONSENSETEN FLEAS"	"WA"	"Commonsense Ten and NEA"
"USSEN/WA NRSC MORE"	"WA"	
"USSEN/WA NRSC PENNY"	"WA"	
"USSEN/WA NRSC TRANSFORMATION"	"WA"	
"USSEN/WA NRSC&ROSSI CHANGED"	"WA"	
"USSEN/WA NRWC FORCED UNIONISM 60"	"WA"	"National Right to Work Committee"
"USSEN/WA ROSSI CHANGED"	"WA"	
"USSEN/WA ROSSI MISERY"	"WA"	
"USSEN/WA ROSSI MURRAY'S MISTAKES 11 15"	"WA"	
"USSEN/WA ROSSI MURRAY'S MISTAKES 3 15"	"WA"	
"USSEN/WA ROSSI OVER THE TOP"	"WA"	
"USSEN/WA ROSSI PART OF THE PROBLEM"	"WA"	
"USSEN/WA ROSSI SHE CHANGED"	"WA"	
"USSEN/WA ROSSI WHICH ONE"	"WA"	
"USSEN/WA ROSSI WHO WROTE THE BILL"	"WA"	
"USSEN/WA ROSSI WISELY"	"WA"	
"USSEN/WA ROSSI YESTERDAY"	"WA"	
"USSEN/WA STABLEQUALITYCARE TOO HARD MURRAY"	"WA"	"Americans for Stable Quality Care"
"USSEN/WA USCOC AMERICAN DREAM"	"WA"	"US Chamber of Commerce"
"USSEN/WI AAN BUCKET"	"WI"	"American Action Network"
"USSEN/WI AAN SMALL CHANGE"	"WI"	"American Action Network"
"USSEN/WI ALG JUDGE CHATIGNY 60"	"WI"	"Americans for Limited Government"
"USSEN/WI CFG ENOUGH"	"WI"	"Club for Growth"
"USSEN/WI FEINGOLD 55"	"WI"	
"USSEN/WI FEINGOLD CREATIVE DESTRUCTION"	"WI"	
"USSEN/WI FEINGOLD EARNED IT"	"WI"	
"USSEN/WI FEINGOLD FOR US"	"WI"	
"USSEN/WI FEINGOLD FORWARD"	"WI"	
"USSEN/WI FEINGOLD GARAGE DOOR"	"WI"	
"USSEN/WI FEINGOLD HIS OWN WORDS"	"WI"	
"USSEN/WI FEINGOLD HOMEGROWN"	"WI"	
"USSEN/WI FEINGOLD JUST SAY NO"	"WI"	
"USSEN/WI FEINGOLD LOOKS OUT FOR US"	"WI"	
"USSEN/WI FEINGOLD NO VIKINGS"	"WI"	
"USSEN/WI FEINGOLD NO VIKINGS REV"	"WI"	
"USSEN/WI FEINGOLD OFF THE TABLE"	"WI"	
"USSEN/WI FEINGOLD ON OUR SIDE"	"WI"	
"USSEN/WI FEINGOLD ON YOUR SIDE"	"WI"	
"USSEN/WI FEINGOLD TESTIMONY"	"WI"	
"USSEN/WI FEINGOLD TRUST"	"WI"	
"USSEN/WI FEINGOLD WHITEBOARD"	"WI"	
"USSEN/WI FEINGOLD&WIDP TRUST"	"WI"	
"USSEN/WI FEINGOLD&WIDP WHITEBOARD"	"WI"	
"USSEN/WI JOHNSON 14 TRILLION"	"WI"	
"USSEN/WI JOHNSON 18 YEARS"	"WI"	
"USSEN/WI JOHNSON 57"	"WI"	
"USSEN/WI JOHNSON APPLE PIE"	"WI"	
"USSEN/WI JOHNSON CLEAR CHOICE"	"WI"	
"USSEN/WI JOHNSON DESPERATE"	"WI"	
"USSEN/WI JOHNSON FAMILY"	"WI"	
"USSEN/WI JOHNSON FEINGOLD MUD"	"WI"	
"USSEN/WI JOHNSON FUTURE"	"WI"	
"USSEN/WI JOHNSON LIKE THE REST OF THEM"	"WI"	
"USSEN/WI JOHNSON LISTENING"	"WI"	
"USSEN/WI JOHNSON MADE IN AMERICA"	"WI"	
"USSEN/WI JOHNSON MAVERICK"	"WI"	
"USSEN/WI JOHNSON MONEY SPENT"	"WI"	
"USSEN/WI JOHNSON PENNY PINCHER"	"WI"	
"USSEN/WI JOHNSON REAL WORLD"	"WI"	
"USSEN/WI JOHNSON THE JOHNSON WAY"	"WI"	
"USSEN/WI JOHNSON TIPPING POINT"	"WI"	
"USSEN/WI JOHNSON&NRSC DESPERATE"	"WI"	
"USSEN/WI JOHNSON&NRSC STEP UP"	"WI"	
"USSEN/WI NRA RON JOHNSON"	"WI"	"NRA"
"USSEN/WI PAGELS BORN AGAIN 60"	"WI"	
"USSEN/WI SPEECHNOW TWO FEINGOLDS"	"WI"	"SpeechNow.org"
"USSEN/WI USCOC STANDS WITH THEM"	"WI"	"US Chamber of Commerce"
"USSEN/WI WALL FED UP"	"WI"	
"USSEN/WI WALL REBUILD"	"WI"	
"USSEN/WV AAN CHECK AND BALANCE"	"WV"	"American Action Network"
"USSEN/WV ACC MANCHIN A LEADER"	"WV"	"American Chemistry Council"
"USSEN/WV AJS TURTLE CROSSING"	"WV"	"Americans for Job Security"
"USSEN/WV AJS YOU'VE HEARD"	"WV"	"Americans for Job Security"
"USSEN/WV C4SS JOBS MANCHIN"	"WV"	"Citizens for Strength and Security"
"USSEN/WV DSCC FLORIDA"	"WV"	
"USSEN/WV DSCC MADE IN AMERICA"	"WV"	
"USSEN/WV DSCC OPPOSES"	"WV"	
"USSEN/WV DSCC RAESE'S WAY"	"WV"	
"USSEN/WV DSCC SPREADSHEET"	"WV"	
"USSEN/WV FAA DESERVE BETTER"	"WV"	"First Amendment Alliance"
"USSEN/WV HECHLER FIRST IN HEARTS 10"	"WV"	
"USSEN/WV MANCHIN BELIEVE"	"WV"	
"USSEN/WV MANCHIN COMMONSENSE VALUES"	"WV"	
"USSEN/WV MANCHIN DEAD AIM"	"WV"	
"USSEN/WV MANCHIN FIGHTING FOR WEST VIRGINIA"	"WV"	
"USSEN/WV MANCHIN GOOD MESSAGE"	"WV"	
"USSEN/WV MANCHIN HICKS"	"WV"	
"USSEN/WV MANCHIN NO WONDER"	"WV"	
"USSEN/WV MANCHIN PRIORITIES"	"WV"	
"USSEN/WV MANCHIN TRUST"	"WV"	
"USSEN/WV MANCHIN USES PEOPLE"	"WV"	
"USSEN/WV NRSC CHANGE"	"WV"	
"USSEN/WV NRSC HUNTING TRIP"	"WV"	
"USSEN/WV NRSC STOP OBAMA"	"WV"	
"USSEN/WV NRSC WASHINGTON"	"WV"	
"USSEN/WV RAESE CAP AND TRADE"	"WV"	
"USSEN/WV RAESE CREATED JOBS"	"WV"	
"USSEN/WV RAESE IT'S CLEAR"	"WV"	
"USSEN/WV RAESE NEVER A RUBBER STAMP"	"WV"	
"USSEN/WV RAESE NEW DIRECTION"	"WV"	
"USSEN/WV RAESE NOT PERFECT"	"WV"	
"USSEN/WV RAESE OBAMACARE"	"WV"	
"USSEN/WV RAESE OUTRAGE"	"WV"	
"USSEN/WV RAESE REPEAL OBAMACARE"	"WV"	
"USSEN/WV RAESE RUBBER STAMP JOE REV"	"WV"	
"USSEN/WV RAESE SAY IT AIN'T SO JOE"	"WV"	
"USSEN/WV RAESE TESTIMONIALS"	"WV"	
"USSEN/WV WARNER 60TH VOTE"	"WV"	
