postêpowaniezgodnezetyk¹	postêpowaæzgodnyzetyka
" zgodnoœæ z etyk¹"	"  zgodnoœæ  z  etyka "
" etyka pracownicza"	"  etyk pracowniczy "
" etyczne postêpowanie"	"  etyczny postêpowaæ "
" postêpowanie etyczne"	"  postêpowaæ etyczny "
" etyka pracy"	"  etyk praca "
" identyfikowanie efektów spo³ecznych"	"  identyfikowaæ efekt:efekta spo³eczny "
" poznawanie oddzia³ywania spo³ecznego"	"  poznawaæ oddzia³ywanie:oddzia³ywaæ spo³eczny "
" rozpoznawanie wp³ywu spo³ecznego"	"  rozpoznawaæ wp³yw spo³eczny "
" ocena wp³ywu spo³ecznego"	"  ocena  wp³yw spo³eczny "
" okreœlenie wp³ywu spo³ecznego"	"  okreœliæ wp³yw spo³eczny "
" efekty spo³eczne"	"  efekt spo³eczny "
" spo³eczne efekty"	"  spo³eczny efekt "
" oddzia³ywanie spo³eczne"	"  oddzia³ywaæ spo³eczny "
" spo³eczne oddzia³ywanie"	"  spo³eczny oddzia³ywaæ "
" wp³yw spo³eczny"	"  wp³yw  spo³eczny  "
" spo³eczny wp³yw"	"  spo³eczny  wp³yw  "
" zastanawianie siê nad w³asn¹ metod¹ pracy"	"  zastanawiaæ siê  nad  w³asny metoda praca "
" przemyœlane praktyki pracy"	"  przemyœlaæ:przemyœleæ praktyk:praktyka praca "
" zwracanie uwagi na praktyki postêpowania"	"  zwracaæ uwaga na  praktyk:praktyka postêpowanie:postêpowaæ "
" przemyœlane zasady pracy"	"  przemyœlaæ:przemyœleæ zasada praca "
" przemyœlane wykonywanie obowi¹zków"	"  przemyœlaæ:przemyœleæ wykonywaæ obowi¹zek "
" praktyki pracy"	"  praktyk:praktyka praca "
" metoda pracy"	"  metoda  praca "
" praktyki postêpowania"	"  praktyk:praktyka postêpowanie:postêpowaæ "
" zasady pracy"	"  zasada praca "
" zasady postêpowania"	"  zasada postêpowanie:postêpowaæ "
" dobre wykonywanie obowi¹zków"	"  dobry wykonywaæ obowi¹zek "
" prawid³owe wykonywanie obowi¹zków"	"  prawid³owy wykonywaæ obowi¹zek "
" ocena wp³ywu na otoczenie"	"  ocena  wp³yw na  otoczyæ "
" ocena wp³ywu na œrodowisko pracy"	"  ocena  wp³yw na  œrodowisko  praca "
" identyfikowanie skutków dla otoczenia"	"  identyfikowaæ skutek dla  otoczenie:otoczyæ "
" okreœlenie skutków dla œrodowiska pracy"	"  okreœliæ skutek dla  œrodowisko praca "
" wp³yw œrodowiskowy"	"  wp³yw  œrodowiskowy  "
" wp³yw na œrodowisko pracy"	"  wp³yw  na  œrodowisko  praca "
" skutki dla œrodowiska pracy"	"  skutek dla  œrodowisko praca "
" wp³yw na otoczenie"	"  wp³yw  na  otoczyæ "
" skutki dla otoczenia"	"  skutek dla  otoczenie:otoczyæ "
" efekty œrodowiskowe"	"  efekt œrodowiskowy "
" œrodowiskowe efekty"	"  œrodowiskowy efekt "
" œrodowiskowy wp³yw"	"  œrodowiskowy  wp³yw  "
" etyczne wybory"	"  etyczny wybór "
" dokonywanie etycznych wyborów"	"  dokonywaæ etyczny wybory:wybór "
" etyczna praca"	"  etyczny praca  "
" identyfikacja kwestii etycznych"	"  identyfikacja  kwestia etyczny "
" znajomoœæ problemów etycznych"	"  znajomoœæ  problem etyczny "
" ocena zagadnieñ etycznych"	"  ocena  zagadnienie etyczny "
" zagadnienia etyczne"	"  zagadnienie etyczny "
" problemy etyczne"	"  problem etyczny "
" etyczne problemy"	"  etyczny problem "
" etyczne zagadnienia"	"  etyczny zagadnienie "
" œwiadomoœæ problemów etycznych"	"  œwiadomoœæ  problem etyczny "
" œwiadomoœæ etyki"	"  œwiadomoœæ  etyk:etyka "
" okazywanie szacunku"	"  okazywaæ szacunek "
" sprawiedliwe traktowanie"	"  sprawiedliwy traktowaæ "
" uczciwe traktowanie"	"  uczciwy traktowaæ "
" uczciwoœæ"	"  uczciwoœæ  "
"uczciwoœæ"	""
" sprawiedliwoœæ"	"  sprawiedliwoœæ  "
"sprawiedliwoœæ"	""
" szanowanie odmiennych punktów widzenia"	"  szanowaæ odmienny punkt widzenie:widzieæ "
" praca w warunkach odmiennych perspektyw"	"  praca  wiek warunki:warunek odmienny perspektywa "
" szanowanie ró¿nych perspektyw"	"  szanowaæ ró¿ny perspektywa "
" szacunek dla innych podejœæ"	"  szacunek  dla  inny podejœcie "
" otwartoœæ na pogl¹dy"	"  otwartoœæ  na  pogl¹d "
" szacunek"	"  szacunek  "
"szacunek"	""
" otwartoœæ na ludzi"	"  otwartoœæ  na  ludzie:cz³owiek "
" okazywanie rozwagi"	"  okazywaæ rozwaga "
" rozwaga"	"  rozwaga  "
"rozwaga"	""
" dyskrecja"	"  dyskrecja  "
"dyskrecja"	""
" demonstrowanie tolerancji"	"  demonstrowaæ tolerancja "
" tolerancja"	"  tolerancja  "
"tolerancja"	""
" wyrozumia³oœæ"	"  wyrozumia³oœæ  "
"wyrozumia³oœæ"	""
" cierpliwoœæ"	"  cierpliwoœæ  "
"cierpliwoœæ"	""
" okazywanie dobrych manier"	"  okazywaæ dobry:dobre:dobre maniera:maniery "
" maniery"	"  manier:maniera "
"maniery:manier:maniera"	""
" kultura osobista"	"  kultura  osobisty "
" etykieta"	"  etykieta  "
"etykieta"	""
" pogodne usposobienie"	"  pogodny usposobiæ "
" pogodnoœæ"	"  pogodnoœæ  "
"pogodnoœæ"	""
" ³agodnoœæ"	"  ³agodnoœæ  "
"³agodnoœæ"	""
" wykazywanie zaanga¿owania"	"  wykazywaæ zaanga¿owanie:zaanga¿owaæ "
" zaanga¿owanie"	"  zaanga¿owaæ "
"zaanga¿owanie:zaanga¿owaæ"	""
" zainteresowanie prac¹"	"  zainteresowaæ praca "
" chêæ do pracy"	"  chêciæ do  praca "
" ambicja"	"  ambicja  "
"ambicja"	""
" motywacja"	"  motywacja  "
"motywacja"	""
" wype³nianie zobowi¹zañ"	"  wype³niaæ zobowi¹zanie "
" bycie s³ownym"	"  byt:byæ s³owny "
" odpowiedzialnoœæ"	"  odpowiedzialnoœæ  "
"odpowiedzialnoœæ"	""
" terminowoœæ"	"  terminowoœæ  "
"terminowoœæ"	""
" wype³nianie obowi¹zków"	"  wype³niaæ obowi¹zek "
" rzetelnoœæ"	"  rzetelnoœæ  "
"rzetelnoœæ"	""
" jakoœæ pracy"	"  jakoœæ  praca "
" wartoœciowa praca"	"  wartoœciowy praca  "
" staraæ siê"	"  staraæ  siê  "
" dok³adaæ starañ"	"  dok³adaæ  staranie "
" podejmowaæ wysi³ek"	"  podejmowaæ  wysi³ek  "
" wytê¿ona praca"	"  wytê¿ony:wytê¿yæ praca  "
" wysilanie siê"	"  wysilaæ siê  "
" samodyscyplina"	"  samodyscyplina  "
"samodyscyplina"	""
" dyscyplina"	"  dyscyplina  "
"dyscyplina"	""
" inicjatywa"	"  inicjatywa  "
"inicjatywa"	""
" zwracanie uwagi na szczegó³y"	"  zwracaæ uwaga na  szczegó³ "
" dok³adna praca"	"  dok³adny praca  "
" szczegó³owoœæ"	"  szczegó³owoœæ  "
"szczegó³owoœæ"	""
" dok³adnoœæ"	"  dok³adnoœæ  "
"dok³adnoœæ"	""
" dba³oœæ w pracy"	"  dba³oœæ  wiek praca "
" dba³oœæ o szczegó³y"	"  dba³oœæ  ocean:ojciec szczegó³ "
" starannoœæ"	"  starannoœæ  "
"starannoœæ"	""
" skrupulatnoœæ"	"  skrupulatnoœæ  "
"skrupulatnoœæ"	""
" pieczo³owitoœæ"	"  pieczo³owitoœæ  "
"pieczo³owitoœæ"	""
" sumiennoœæ"	"  sumiennoœæ  "
"sumiennoœæ"	""
" entuzjazm"	"  entuzjazm  "
"entuzjazm"	""
" entuzjastyczne podejœcie"	"  entuzjastyczny podejœæ "
" okazywaæ zapa³"	"  okazywaæ  zapa³  "
" zapa³"	"  zapa³  "
"zapa³"	""
" dynamizm w dzia³aniu"	"  dynamizm  wiek dzia³anie:dzia³aæ "
" dynamizm"	"  dynamizm  "
"dynamizm"	""
" pozytywne nastawienie"	"  pozytywny nastawiæ "
" pozytywne myœlenie"	"  pozytywny myœleæ:myœliæ "
" nastawienie pozytywne"	"  nastawiæ pozytywny "
" myœlenie pozytywne"	"  myœleæ:myœliæ pozytywny "
" ciekawoœæ"	"  ciekawoœæ  "
"ciekawoœæ"	""
" dociekliwoœæ"	"  dociekliwoœæ  "
"dociekliwoœæ"	""
" chêæ poznania"	"  chêciæ poznanie:poznaæ "
" g³ód wiedzy"	"  g³ód  wiedza "
" upór"	"  upór  "
"upór"	""
" wytrwa³oœæ"	"  wytrwa³oœæ  "
"wytrwa³oœæ"	""
" zaciêcie"	"  zaci¹æ "
"zaciêcie:zaci¹æ"	""
" zaciêtoœæ"	"  zaciêtoœæ  "
"zaciêtoœæ"	""
" zawziêtoœæ"	"  zawziêtoœæ  "
"zawziêtoœæ"	""
" nieustêpliwoœæ"	"  nieustêpliwoœæ  "
"nieustêpliwoœæ"	""
" niestrudzonoœæ"	"  niestrudzonoœæ  "
"niestrudzonoœæ"	""
" niez³omnoœæ"	"  niez³omnoœæ  "
"niez³omnoœæ"	""
" nieugiêtoœæ"	"  nieugiêtoœæ  "
"nieugiêtoœæ"	""
" bezkompromisowoœæ"	"  bezkompromisowoœæ  "
"bezkompromisowoœæ"	""
" przebojowoœæ"	"  przebojowoœæ  "
"przebojowoœæ"	""
" stanowczoœæ"	"  stanowczoœæ  "
"stanowczoœæ"	""
" silna wola"	"  silny wole:woli "
" determinacja"	"  determinacja  "
"determinacja"	""
" odwaga"	"  odwaga  "
"odwaga"	""
" osoba zdecydowana"	"  osoba  zdecydowany:zdecydowaæ "
" cz³owiek zdecydowany"	"  cz³owiek  zdecydowaæ "
" zdecydowana osoba"	"  zdecydowany:zdecydowaæ osoba  "
" zdecydowany cz³owiek"	"  zdecydowaæ cz³owiek  "
" wykazywanie zdecydowania"	"  wykazywaæ zdecydowanie:zdecydowaæ "
" samodzielnoœæ"	"  samodzielnoœæ  "
"samodzielnoœæ"	""
" niezale¿noœæ"	"  niezale¿noœæ  "
"niezale¿noœæ"	""
" autonomia"	"  autonomia  "
"autonomia"	""
" autonomicznoœæ"	"  autonomicznoœæ  "
"autonomicznoœæ"	""
" samowystarczalnoœæ"	"  samowystarczalnoœæ  "
"samowystarczalnoœæ"	""
" poleganie na sobie"	"  polegaæ na  siê "
" sprawnoœæ"	"  sprawnoœæ  "
"sprawnoœæ"	""
" skutecznoœæ"	"  skutecznoœæ  "
"skutecznoœæ"	""
" efektywnoœæ"	"  efektywnoœæ  "
"efektywnoœæ"	""
" wydajnoœæ"	"  wydajnoœæ  "
"wydajnoœæ"	""
" energicznoœæ"	"  energicznoœæ  "
"energicznoœæ"	""
" operatywnoœæ"	"  operatywnoœæ  "
"operatywnoœæ"	""
" produktywnoœæ"	"  produktywnoœæ  "
"produktywnoœæ"	""
" orientacja na rezultat"	"  orientacja  na  rezultat  "
" nastawienie na wyniki"	"  nastawiæ na  wynik "
" nastawienie na rezultat"	"  nastawiæ na  rezultat  "
" orientacja na wyniki"	"  orientacja  na  wynik "
" realizowanie celów"	"  realizowaæ cel "
" radzenie sobie z wyzwaniami"	"  radziæ siê z  wyzwanie "
" otwartoœæ na wyzwania"	"  otwartoœæ  na  wyzwanie:wyzwaæ "
" elastycznoœæ"	"  elastycznoœæ  "
"elastycznoœæ"	""
" zarz¹dzanie stresem"	"  zarz¹dzaæ stres "
" odpornoœæ na stres"	"  odpornoœæ  na  stres  "
" radzenie sobie z frustracj¹"	"  radziæ siê z  frustracja "
" radzenie sobie ze stresem"	"  radziæ siê z stres "
" odpornoœæ na frustracjê"	"  odpornoœæ  na  frustracja "
" tolerancja stresu"	"  tolerancja  stres "
" tolerancja frustracji"	"  tolerancja  frustracja "
" radzenie sobie z ciœnieniem"	"  radziæ siê z  ciœnienie "
" tolerancja na presjê"	"  tolerancja  na  presja "
" odpornoœæ na presjê"	"  odpornoœæ  na  presja "
" odpornoœæ na ciœnienie"	"  odpornoœæ  na  ciœnienie  "
" radzenie sobie z presj¹"	"  radziæ siê z  presja "
" radzenie sobie z ciœnieniem"	"  radziæ siê z  ciœnienie "
" tolerancja na ciœnienie"	"  tolerancja  na  ciœnienie  "
" dzia³anie w warunkach niepewnoœci"	"  dzia³aæ wiek warunki:warunek niepewnoœæ "
" zarz¹dzanie kryzysowe"	"  zarz¹dzaæ kryzysowy "
" uczenie siê na b³êdach"	"  uczyæ siê  na  b³¹d "
" dostosowanie do zmian"	"  dostosowaæ do  zmiana "
" adaptowanie siê do zmian"	"  adaptowaæ siê  do  zmiana "
" adaptowanie siê"	"  adaptowaæ siê  "
" wykorzystywanie doœwiadczeñ"	"  wykorzystywaæ doœwiadczenie "
" budowanie doœwiadczeñ"	"  budowaæ doœwiadczenie "
" interakcja w formie elektronicznej"	"  interakcja  wiek formia:forma elektroniczny "
" interakcja elektroniczna"	"  interakcja  elektroniczny "
" elektroniczna interakcja"	"  elektroniczny interakcja  "
" komunikacja on-line"	"  komunikacja  on-line  "
" porozumiewanie siê poprzez sieæ"	"  porozumiewaæ siê  poprzez  sieæ  "
" komunikacja internetowa"	"  komunikacja  internetowy "
" komunikacja za poœrednictwem internetu"	"  komunikacja  za  poœrednictwo internet "
" wykorzystywanie telefonu komórkowego"	"  wykorzystywaæ telefon komórkowy "
" u¿ywanie telefonu komórkowego"	"  u¿ywaæ telefon komórkowy "
" wybór metody interakcji elektronicznej"	"  wybór  metoda interakcja elektroniczny "
" metoda interakcji elektronicznej"	"  metoda  interakcja elektroniczny "
" metoda elektronicznej interakcji"	"  metoda  elektroniczny interakcja "
" netykieta"	"  netykieta  "
"netykieta"	""
" etykieta w internecie"	"  etykieta  wiek internet:internet "
" korzystnie z us³ug on-line"	"  korzystnie  z  us³uga:us³ugi on-line  "
" korzystanie z us³ug w sieci"	"  korzystaæ z  us³uga:us³ugi wiek sieæ "
" operowanie sprzêtem"	"  operowaæ sprzêt "
" u¿ytkowanie hardware"	"  u¿ytkowaæ hardware  "
" u¿ytkowanie sprzêtu"	"  u¿ytkowaæ sprzêt "
" obs³uga sprzêtu"	"  obs³uga  sprzêt "
" obs³uga hardware"	"  obs³uga  hardware  "
" obs³uga drukarki"	"  obs³uga  drukarka "
" u¿ytkowanie drukarki"	"  u¿ytkowaæ drukarka "
" korzystanie z drukarki"	"  korzystaæ z  drukarka "
" wykorzystywanie drukarki"	"  wykorzystywaæ drukarka "
" u¿ywane drukarki"	"  u¿ywaæ drukarka "
" obs³uga urz¹dzeñ wskazuj¹cych"	"  obs³uga  urz¹dzenie wskazywaæ "
" u¿ywanie urz¹dzeñ wskazuj¹cych"	"  u¿ywaæ urz¹dzenie wskazywaæ "
" korzystanie z urz¹dzeñ wskazuj¹cych"	"  korzystaæ z  urz¹dzenie wskazywaæ "
" wykorzystywanie urz¹dzeñ wskazuj¹cych"	"  wykorzystywaæ urz¹dzenie wskazywaæ "
" u¿ytkowanie urz¹dzeñ wskazuj¹cych"	"  u¿ytkowaæ urz¹dzenie wskazywaæ "
" obs³uga skanera"	"  obs³uga  skaner "
" u¿ywanie skanera"	"  u¿ywaæ skaner "
" korzystanie ze skanera"	"  korzystaæ z skaner "
" u¿ytkowanie skanera"	"  u¿ytkowaæ skaner "
" wykorzystywanie skanera"	"  wykorzystywaæ skaner "
" zarz¹dzanie informacj¹ elektroniczn¹"	"  zarz¹dzaæ informacja elektroniczny "
" msoffice"	"  msoffice  "
" msoffice"	"  msoffice  "
" przetwarzanie tekstu"	"  przetwarzaæ tekst "
" edytor tekstu"	"  edytor  tekst "
" przetwarzanie s³ów"	"  przetwarzaæ s³owa:s³owiæ:s³owo "
" msword"	"  msword  "
" msword"	"  msword  "
" pobieranie plików"	"  pobieraæ plik "
" odzyskiwanie plików"	"  odzyskiwaæ plik "
" wykrywanie obci¹¿enia informacji elektronicznej"	"  wykrywaæ obci¹¿enie:obci¹¿yæ informacja elektroniczny "
" wykrywanie niedok³adnoœci informacji elektronicznej"	"  wykrywaæ niedok³adnoœæ informacja elektroniczny "
" ocena jakoœci informacji elektronicznej"	"  ocena  jakoœæ informacja elektroniczny "
" ocena informacji elektronicznej"	"  ocena  informacja elektroniczny "
" ocena elektronicznej informacji"	"  ocena  elektroniczny informacja "
" jakoœæ informacji elektronicznej"	"  jakoœæ  informacja elektroniczny "
" jakoœæ elektronicznej informacji"	"  jakoœæ  elektroniczny informacja "
" jakoœæ informacji w sieci"	"  jakoœæ  informacja wiek sieæ "
" ocena informacji w sieci"	"  ocena  informacja wiek sieæ "
" u¿ywanie arkusza kalkulacyjnego"	"  u¿ywaæ arkusz kalkulacyjny "
" obs³uga arkusza kalkulacyjnego"	"  obs³uga  arkusz kalkulacyjny "
" korzystanie z arkusza kalkulacyjnego"	"  korzystaæ z  arkusz kalkulacyjny "
" znajomoœæ arkusza kalkulacyjnego"	"  znajomoœæ  arkusz kalkulacyjny "
" znajomoœæ excela"	"  znajomoœæ  excela  "
" znajomoœæ msexcel"	"  znajomoœæ  msexcel  "
" korzystanie z excela"	"  korzystaæ z  excela  "
" wykorzystywanie excela"	"  wykorzystywaæ excela  "
" wykorzystywanie msexcel"	"  wykorzystywaæ msexcel  "
" u¿ywanie excela"	"  u¿ywaæ excela  "
" u¿ytkowanie excela"	"  u¿ytkowaæ excela  "
" obs³uga excela"	"  obs³uga  excela  "
" u¿ywanie msexcel"	"  u¿ywaæ msexcel  "
" u¿ytkowanie msexcel"	"  u¿ytkowaæ msexcel  "
" obs³uga msexcel"	"  obs³uga  msexcel  "
" u¿ywanie elektronicznych baz danych"	"  u¿ywaæ elektroniczny baza dany:dana:dane:daæ "
" elektroniczne bazy danych"	"  elektroniczny baza dany:dana:dane:daæ "
" u¿ywanie baz danych"	"  u¿ywaæ baza dany:dana:dane:daæ "
" znajomoœæ baz danych"	"  znajomoœæ  baza dany:dana:dane:daæ "
" znajomoœæ msaccess"	"  znajomoœæ  msaccess  "
" u¿ywanie msaccess"	"  u¿ywaæ msaccess  "
" wykorzystywanie msaccess"	"  wykorzystywaæ msaccess  "
" obs³uga msaccess"	"  obs³uga  msaccess  "
" obs³uga baz danych"	"  obs³uga  baza dany:dana:dane:daæ "
" zachowywanie plików"	"  zachowywaæ plik "
" zapisywanie plików"	"  zapisywaæ plik "
" krzy¿owa weryfikacja informacji elektronicznej"	"  krzy¿owy weryfikacja  informacja elektroniczny "
" weryfikacja informacji elektronicznej"	"  weryfikacja  informacja elektroniczny "
" operowanie oprogramowaniem"	"  operowaæ oprogramowanie:oprogramowaæ "
" obs³uga software"	"  obs³uga  software  "
" obs³uga oprogramowania"	"  obs³uga  oprogramowanie:oprogramowaæ "
" znajomoœæ oprogramowania biurowego"	"  znajomoœæ  oprogramowanie:oprogramowaæ biurowy "
" oprogramowanie biurowe"	"  oprogramowaæ biurowy "
" programy biurowe"	"  program biurowy "
" znajomoœæ systemów operacyjnych"	"  znajomoœæ  system operacyjny "
" system operacyjny"	"  systema operacyjny  "
" linux"	"  linux  "
" windows"	"  windows  "
" android"	"  android  "
"android"	""
" tworzenie treœci elektronicznych"	"  tworzyæ treœæ elektroniczny "
" generowanie obrazów elektronicznych"	"  generowaæ obraz elektroniczny "
" elektroniczna obróbka zdjêæ"	"  elektroniczny obróbka  zdjêcia:zdjêcie "
" generowanie obrazków"	"  generowaæ obrazek "
" rysunek elektroniczny"	"  rysunek  elektroniczny  "
" tworzenie rysunków"	"  tworzyæ rysunki:rysunek "
" tworzenie obrazków"	"  tworzyæ obrazek "
" generowanie tabel"	"  generowaæ tabela "
" tworzenie zestawieñ tabelarycznych"	"  tworzyæ zestawienie tabelaryczny "
" edycja zawartoœci elektronicznej"	"  edycja  zawartoœæ elektroniczny "
" pisanie"	"  pisaæ "
"pisanie:pisaæ"	""
" obs³uga klawiatury"	"  obs³uga  klawiatura "
" projektowanie arkuszy kalkulacyjnych"	"  projektowaæ arkusz kalkulacyjny "
" dokonywanie obliczeñ w arkuszu kalkulacyjnym"	"  dokonywaæ obliczenie wiek arkusz kalkulacyjny "
" tworzenie arkuszy kalkulacyjnych"	"  tworzyæ arkusz kalkulacyjny "
" projektowanie excela"	"  projektowaæ excela  "
" tworzenie w excelu"	"  tworzyæ wiek excelu  "
" projektowanie msexcel"	"  projektowaæ msexcel  "
" tworzenie w msexcel"	"  tworzyæ wiek msexcel  "
" tworzenie plików msexcel"	"  tworzyæ plik msexcel  "
" tworzenie plików excela"	"  tworzyæ plik excela  "
" tworzenie plików audio"	"  tworzyæ plik audio  "
" tworzenie plików dŸwiêkowych"	"  tworzyæ plik dŸwiêkowy "
" przetwarzanie dŸwiêku"	"  przetwarzaæ dŸwiêk "
" tworzenie plików tekstowych"	"  tworzyæ plik tekstowy "
" tworzenie tekstu"	"  tworzyæ tekst "
" utrzymywanie prywatnoœci w internecie"	"  utrzymywaæ prywatnoœæ wiek internet:internet "
" utrzymywanie bezpieczeñstwa w internecie"	"  utrzymywaæ bezpieczeñstwo wiek internet:internet "
" utrzymywanie internetowej prywatnoœci"	"  utrzymywaæ internetowy prywatnoœæ "
" utrzymywanie internetowego bezpieczeñstwa"	"  utrzymywaæ internetowy bezpieczeñstwo "
" prywatnoœæ w internecie"	"  prywatnoœæ  wiek internet:internet "
" ustawienia prywatnoœci w internecie"	"  ustawienie:ustawiæ prywatnoœæ wiek internet:internet "
" internetowa ochrona prywatnoœci"	"  internetowy ochrona  prywatnoœæ "
" aktualizacja internetowych œrodków bezpieczeñstwa"	"  aktualizacja  internetowy œrodki:œrodek bezpieczeñstwo "
" update œrodków ochrony online"	"  update  œrodki:œrodek ochrona online  "
" aktualizacja œrodków bezpieczeñstwa w internecie"	"  aktualizacja  œrodki:œrodek bezpieczeñstwo wiek internet:internet "
" instalowanie oprogramowania antywirusowego"	"  instalowaæ oprogramowanie:oprogramowaæ antywirusowy "
" instalowanie programów antywirusowych"	"  instalowaæ program antywirusowy "
" instalowanie antywirusów"	"  instalowaæ antywirus "
" wybór internetowych œrodków bezpieczeñstwa"	"  wybór  internetowy œrodki:œrodek bezpieczeñstwo "
" wybór œrodków bezpieczeñstwa w internecie"	"  wybór  œrodki:œrodek bezpieczeñstwo wiek internet:internet "
" identyfikacja zagro¿eñ internetowych"	"  identyfikacja  zagro¿enie internetowy "
" identyfikacja zagro¿eñ w internecie"	"  identyfikacja  zagro¿enie wiek internet:internet "
" rozpoznanie zagro¿eñ internetowych"	"  rozpoznaæ zagro¿enie internetowy "
" rozpoznanie zagro¿eñ w internecie"	"  rozpoznaæ zagro¿enie wiek internet:internet "
" tworzenie hase³"	"  tworzyæ has³o "
" tworzenie ustawieñ prywatnoœci"	"  tworzyæ ustawienie prywatnoœæ "
" poszukiwanie informacji drog¹ elektroniczn¹"	"  poszukiwaæ informacja droga:drogi elektroniczny "
" znajomoœæ przegl¹darek internetowych"	"  znajomoœæ  przegl¹darka internetowy "
" przegl¹darki internetowe"	"  przegl¹darka internetowy "
" poszukiwanie informacji internetowej"	"  poszukiwaæ informacja internetowy "
" wyszukiwarki internetowe"	"  wyszukiwarka internetowy "
" przetwarzanie informacji liczbowych do pracy"	"  przetwarzaæ informacja liczbowy do  praca "
" przetwarzanie danych"	"  przetwarzaæ dany:dana:dane:daæ "
" analiza danych"	"  analiza  dany:dana:dane:daæ "
" synteza danych"	"  synteza  dany:dana:dane:daæ "
" porz¹dkowanie danych"	"  porz¹dkowaæ dany:dana:dane:daæ "
" organizacja danych"	"  organizacja  dany:dana:dane:daæ "
" interpretowanie danych"	"  interpretowaæ dany:dana:dane:daæ "
" wizualizacja danych"	"  wizualizacja  dany:dana:dane:daæ "
" gromadzenie danych"	"  gromadziæ dany:dana:dane:daæ "
" zbieranie danych"	"  zbieraæ dany:dana:dane:daæ "
" zastosowanie koncepcji matematycznych w pracy"	"  zastosowaæ koncepcja matematyczny wiek praca "
" zastosowanie koncepcji matematycznych"	"  zastosowaæ koncepcja matematyczny "
" techniki matematyczne"	"  technik:technika matematyczny "
" techniki statystyczne"	"  technik:technika statystyczny "
" metody iloœciowe"	"  metoda iloœciowy "
" metody statystyczne"	"  metoda statystyczny "
" metody matematyczne"	"  metoda matematyczny "
" identyfikacja problemów matematycznych"	"  identyfikacja  problem matematyczny "
" identyfikacja problemów iloœciowych"	"  identyfikacja  problem iloœciowy "
" identyfikacja matematycznych problemów"	"  identyfikacja  matematyczny problem "
" identyfikacja iloœciowych problemów"	"  identyfikacja  iloœciowy problem "
" zastosowanie metod matematycznych"	"  zastosowaæ metoda matematyczny "
" zastosowanie metod iloœciowych"	"  zastosowaæ metoda iloœciowy "
" zastosowanie matematyki"	"  zastosowaæ matematyk:matematyka "
" zastosowanie statystyki"	"  zastosowaæ statystyk:statystyka "
" zastosowanie metod statystycznych"	"  zastosowaæ metoda statystyczny "
" zastosowanie technik statystycznych"	"  zastosowaæ technika statystyczny "
" techniki statystyczne"	"  technik:technika statystyczny "
" wybór koncepcji matematycznych"	"  wybór  koncepcja matematyczny "
" wybór procedur matematycznych"	"  wybór  procedura matematyczny "
" dobór pojêæ matematycznych"	"  dobór  pojêcie matematyczny "
" dobór metod iloœciowych"	"  dobór  metoda iloœciowy "
" dobór koncepcji matematycznych"	"  dobór  koncepcja matematyczny "
" dobór technik statystycznych"	"  dobór  technika statystyczny "
" dobór technik matematycznych"	"  dobór  technika matematyczny "
" dobór koncepcji matematycznych"	"  dobór  koncepcja matematyczny "
" dobór procedur matematycznych"	"  dobór  procedura matematyczny "
" dobór metod statystycznych"	"  dobór  metoda statystyczny "
" dobór technik statystycznych"	"  dobór  technika statystyczny "
" u¿ytkowanie narzêdzi matematycznych"	"  u¿ytkowaæ narzêdzie matematyczny "
" u¿ytkowanie programów matematycznych"	"  u¿ytkowaæ program matematyczny "
" obs³uga narzêdzi matematycznych"	"  obs³uga  narzêdzie matematyczny "
" obs³uga programów matematycznych"	"  obs³uga  program matematyczny "
" obs³uga programów statystycznych"	"  obs³uga  program statystyczny "
" obs³uga programów ekonometrycznych"	"  obs³uga  program ekonometryczny "
" programy statystyczne"	"  program statystyczny "
" programy matematyczne"	"  program matematyczny "
" programy ekonometryczne"	"  program ekonometryczny "
" u¿ywanie urz¹dzeñ pomiarowych"	"  u¿ywaæ urz¹dzenie pomiarowy "
" obs³uga przyrz¹dów pomiarowych"	"  obs³uga  przyrz¹d pomiarowy "
" przyrz¹dy pomiarowe"	"  przyrz¹d pomiarowy "
"u¿ywanie kalkulatorów"	"u¿ywaæ kalkulator "
" u¿ywanieict"	"  u¿ywanieict  "
" technologie informacyjne technologie komunikacyjne"	"  technologia informacyjny technologia komunikacyjny "
" interpretacja wiedzy matematycznej"	"  interpretacja  wiedza matematyczny "
" przekazywanie wiedzy matematycznej"	"  przekazywaæ wiedza matematyczny "
" rejestrowanie danych"	"  rejestrowaæ dany:dana:dane:daæ "
" zapisywanie wyników"	"  zapisywaæ wynik "
" objaœnianie wyników matematycznych"	"  objaœniaæ wynik matematyczny "
" wyjaœnianie wyników matematycznych"	"  wyjaœniaæ wynik matematyczny "
" ilustracja rezultatów matematycznych"	"  ilustracja  rezultat matematyczny "
" ilustracja wniosków matematycznych"	"  ilustracja  wniosek matematyczny "
" ilustracja odkryæ matematycznych"	"  ilustracja  odkrycie matematyczny "
" pos³ugiwanie siê jêzykiem matematycznym"	"  pos³ugiwaæ siê  jêzyk matematyczny "
" stosowanie jêzyka matematycznego"	"  stosowaæ jêzyk matematyczny "
" u¿ywanie terminologii matematycznej"	"  u¿ywaæ terminologia matematyczny "
" u¿ywanie terminologii statystycznej"	"  u¿ywaæ terminologia statystyczny "
" przeprowadzanie obliczeñ w pracy"	"  przeprowadzaæ obliczenie wiek praca "
" przeprowadzanie obliczeñ"	"  przeprowadzaæ obliczenie "
" dokonywanie obliczeñ"	"  dokonywaæ obliczenie "
" obliczanie"	"  obliczaæ "
"obliczaæ"	""
" mierzenie"	"  mierzyæ "
"mierzyæ"	""
" dokonywanie pomiarów"	"  dokonywaæ pomiar "
" praca z kszta³tem i przestrzeni¹"	"  praca  z  kszta³t i  przestrzeniæ:przestrzeñ "
" pomiar masy"	"  pomiara masa "
" pomiar objêtoœci"	"  pomiara objêtoœæ "
" pomiar gêstoœci"	"  pomiara gêstoœæ "
" pomiar d³ugoœci"	"  pomiara d³ugoœæ "
" pomiar szerokoœci"	"  pomiara szerokoœæ "
" pomiar wielkoœci"	"  pomiara wielkoœæ "
" pomiar przestrzeni"	"  pomiara przestrzeniæ:przestrzeñ "
" pomiar kubatury"	"  pomiara kubatura "
" pomiar gruboœci"	"  pomiara gruboœæ "
" pomiar odleg³oœci"	"  pomiara odleg³oœæ "
" liczenie"	"  liczyæ "
"liczenie:liczyæ"	""
" korzystanie z liczb"	"  korzystaæ z  liczba "
" wdra¿anie zasad organizacyjnych"	"  wdra¿aæ zasada organizacyjny "
" implementacja zasad organizacji"	"  implementacja  zasada organizacja "
" wspieranie strategii firmy"	"  wspieraæ strategia firma "
" lojalnoœæ"	"  lojalnoœæ  "
"lojalnoœæ"	""
" wspieranie firmowej strategii"	"  wspieraæ firmowy strategia "
" wspieranie strategii przedsiêbiorstwa"	"  wspieraæ strategia przedsiêbiorstwo "
" wspieranie strategii organizacji"	"  wspieraæ strategia organizacja "
" wspieranie misji przedsiêbiorstwa"	"  wspieraæ misja przedsiêbiorstwo "
" wspieranie misji firmy"	"  wspieraæ misja firma "
" wspieranie misji organizacji"	"  wspieraæ misja organizacja "
" wspieranie misji"	"  wspieraæ misja "
" monitorowanie implementacji polityki przedsiêbiorstwa"	"  monitorowaæ implementacja polityk:polityka przedsiêbiorstwo "
" monitorowanie wdro¿enia polityki przedsiêbiorstwa"	"  monitorowaæ wdro¿enie:wdro¿yæ polityk:polityka przedsiêbiorstwo "
" patrzenie na pracê przez pryzmat wartoœci firmy"	"  patrzeæ:patrzyæ na  praca przez  pryzmat  wartoœæ firma "
" monitorowanie wartoœci firmy"	"  monitorowaæ wartoœæ firma "
" stosowanie norm jakoœci"	"  stosowaæ norma jakoœæ "
" przestrzeganie standardów jakoœci"	"  przestrzegaæ standard jakoœæ "
" przestrzeganie norm jakoœci"	"  przestrzegaæ norma jakoœæ "
" stosowanie standardów jakoœci"	"  stosowaæ standard jakoœæ "
" wdra¿anie zrównowa¿onych praktyk w œrodowisku pracy"	"  wdra¿aæ zrównowa¿ony:zrównowa¿yæ praktyka wiek œrodowisko praca "
" minimalizacja ryzyka otoczenia"	"  minimalizacja  ryzyko otoczenie:otoczyæ "
" minimalizacja ryzyka œrodowiskowego"	"  minimalizacja  ryzyko œrodowiskowy "
" zachowanie dziedzictwa œrodowiska naturalnego"	"  zachowaæ dziedzictwo œrodowisko naturalny "
" ocena wp³ywu œrodowiskowego"	"  ocena  wp³yw œrodowiskowy "
" ocena wp³ywu na œrodowisko"	"  ocena  wp³yw na  œrodowisko  "
" okreœlenie skutków dla œrodowiska"	"  okreœliæ skutek dla  œrodowisko "
" wp³yw na œrodowisko naturalne"	"  wp³yw  na  œrodowisko  naturalny "
" skutki dla œrodowiska naturalnego"	"  skutek dla  œrodowisko naturalny "
" ograniczenie praktyk szkodliwych dla œrodowiska"	"  ograniczyæ praktyka szkodliwy dla  œrodowisko "
" ograniczenie wp³ywu na œrodowisko naturalne"	"  ograniczyæ wp³yw na  œrodowisko  naturalny "
" wdra¿anie polityki równoœci"	"  wdra¿aæ polityk:polityka równoœæ "
" rozwa¿anie istnienia ró¿nych kultur"	"  rozwa¿aæ istnienie:istnieæ ró¿ny kultura "
" istnienie ró¿nych kultur"	"  istnieæ ró¿ny kultura "
" wspieranie równoœci p³ci"	"  wspieraæ równoœæ p³eæ "
" równoœæ p³ci"	"  równoœæ  p³eæ "
" sprzyjanie ró¿norodnoœci kulturowej"	"  sprzyjaæ ró¿norodnoœæ kulturowy "
" wdra¿anie polityki bezpieczeñstwa"	"  wdra¿aæ polityk:polityka bezpieczeñstwo "
" bezpieczne przechowywanie sprzêtu"	"  bezpieczny przechowywaæ sprzêt "
" bezpieczne przechowywanie materia³ów"	"  bezpieczny przechowywaæ materia³:materia³y "
" identyfikacja ryzyka"	"  identyfikacja  ryzyko "
" rozpoznanie ryzyka"	"  rozpoznaæ ryzyko "
" stosowanie bezpiecznych metod pracy"	"  stosowaæ bezpieczny metoda praca "
" stosowanie bezpiecznych metod"	"  stosowaæ bezpieczny metoda "
" podejmowanie œrodków ostro¿noœci"	"  podejmowaæ œrodki:œrodek ostro¿noœæ "
" bycie ostro¿nym"	"  byt:byæ ostro¿ny "
" u¿ywanie odpowiedniego sprzêtu"	"  u¿ywaæ odpowiedni sprzêt "
" u¿ywanie odpowiednich narzêdzi"	"  u¿ywaæ odpowiedni narzêdzie "
" odpowiednie u¿ytkowanie sprzêtu"	"  odpowiedni u¿ytkowaæ sprzêt "
" odpowiednie u¿ytkowanie narzêdzi"	"  odpowiedni u¿ytkowaæ narzêdzie "
" odpowiednie korzystanie ze sprzêtu"	"  odpowiedni korzystaæ z sprzêt "
" odpowiednie korzystanie z narzêdzi"	"  odpowiedni korzystaæ z  narzêdzie "
" odpowiednie u¿ywanie sprzêtu"	"  odpowiedni u¿ywaæ sprzêt "
" odpowiednie u¿ywanie narzêdzi"	"  odpowiedni u¿ywaæ narzêdzie "
" umiejêtnoœæ pracy w zespole"	"  umiejêtnoœæ  praca wiek zespó³ "
" umiejêtnoœæ wspó³pracy"	"  umiejêtnoœæ  wspó³praca "
" praca w zespole"	"  praca  wiek zespó³ "
" akceptowanie konstruktywnej krytyki"	"  akceptowaæ konstruktywny krytyk:krytyka "
" akceptowanie krytyki"	"  akceptowaæ krytyk:krytyka "
" dzielenie siê informacj¹"	"  dzieliæ siê  informacja "
" udostêpnianie informacji"	"  udostêpniaæ informacja "
" dzielenie siê wiedz¹"	"  dzieliæ siê  wiedza:wiedzieæ "
" udostêpnianie wiedzy"	"  udostêpniaæ wiedza "
" dawanie konstruktywnej krytyki"	"  dawaæ konstruktywny krytyk:krytyka "
" krytykowanie"	"  krytykowaæ "
"krytykowaæ"	""
" popieranie sieci spo³ecznych"	"  popieraæ sieæ spo³eczny "
" sieci spo³eczne"	"  sieæ spo³eczny "
" dzielenie siê opiniami"	"  dzieliæ siê  opinia "
" opiniowanie"	"  opiniowaæ "
"opiniowaæ"	""
" formu³owanie opinii"	"  formu³owaæ opinia "
" wspó³tworzenie zadañ"	"  wspó³tworzyæ zadanie "
" wspó³praca przy tworzeniu zadañ"	"  wspó³praca  przy  tworzenie:tworzyæ zadanie "
" dzielenie siê zasobami"	"  dzieliæ siê  zasoby:zasób "
" udostêpnianie zasobów"	"  udostêpniaæ zasoby:zasób "
" rozwi¹zywanie konfliktów"	"  rozwi¹zywaæ konflikt "
" oddzia³ywanie"	"  oddzia³ywaæ "
"oddzia³ywanie:oddzia³ywaæ"	""
" wywieranie wp³ywu"	"  wywieraæ wp³yw "
" wp³ywanie"	"  wp³ywaæ "
"wp³ywaæ"	""
" perswadowanie"	"  perswadowaæ "
"perswadowaæ"	""
" perswazyjnoœæ"	"  perswazyjnoœæ  "
"perswazyjnoœæ"	""
" namawianie"	"  namawiaæ "
"namawiaæ"	""
" nak³anianie"	"  nak³aniaæ "
"nak³aniaæ"	""
" argumentowanie"	"  argumentowaæ "
"argumentowaæ"	""
" poszukiwanie konsensusu"	"  poszukiwaæ konsensus "
" d¹¿enie do porozumienia"	"  d¹¿yæ do  porozumienie:porozumieæ "
" poszukiwanie porozumienia"	"  poszukiwaæ porozumienie:porozumieæ "
" konsensus"	"  konsensus  "
"konsensus"	""
" ugodowoœæ"	"  ugodowoœæ  "
"ugodowoœæ"	""
" poszukiwanie kompromisu"	"  poszukiwaæ kompromis "
" d¹¿enie do kompromisu"	"  d¹¿yæ do  kompromis "
" kompromis"	"  kompromis  "
"kompromis"	""
" proponowanie rozwi¹zañ"	"  proponowaæ rozwi¹zanie "
" proponowanie opcji"	"  proponowaæ opcja "
" proponowanie wariantów rozwi¹zañ"	"  proponowaæ wariant rozwi¹zanie "
" proponowanie mo¿liwoœci"	"  proponowaæ mo¿liwoœæ "
" wykazywanie kompetencji wielokulturowych"	"  wykazywaæ kompetencja wielokulturowy "
" kompetencje wielokulturowe"	"  kompetencja wielokulturowy "
" wykonywanie odpowiednich kulturowo gestów"	"  wykonywaæ odpowiedni kulturowo  gest "
" stosowanie odpowiedniego kulturowo jêzyka"	"  stosowaæ odpowiedni kulturowo  jêzyk "
" egzekwowanie odpowiedzialnoœci"	"  egzekwowaæ odpowiedzialnoœæ "
" sprzyjanie jakoœci"	"  sprzyjaæ jakoœæ "
" zachowywanie jakoœci"	"  zachowywaæ jakoœæ "
" przestrzeganie jakoœci"	"  przestrzegaæ jakoœæ "
" tworzenie grup"	"  tworzyæ grupa:grupiæ "
" rozwijanie grup"	"  rozwijaæ grupa:grupiæ "
" budowanie zespo³u"	"  budowaæ zespó³ "
" prowadzenie projektów"	"  prowadziæ projekt "
" wspieranie wspó³pracowników"	"  wspieraæ wspó³pracownik "
" pomaganie kolegom"	"  pomagaæ kolega "
" sprzyjanie zmianom"	"  sprzyjaæ zmiana "
" otwartoœæ na zmiany"	"  otwartoœæ  na  zmiana "
" ustalanie priorytetów"	"  ustalaæ priorytet "
" chronologia zadañ"	"  chronologia  zadanie "
" pierwszeñstwo zadañ"	"  pierwszeñstwo  zadanie "
" priorytetyzacja zadañ"	"  priorytetyzacja  zadanie "
" budowanie relacji"	"  budowaæ relacja "
" zarz¹dzanie zespo³em"	"  zarz¹dzaæ zespó³ "
" zarz¹dzanie ludŸmi"	"  zarz¹dzaæ ludzie:cz³owiek "
" zarz¹dzanie zasobami ludzkimi"	"  zarz¹dzaæ zasoby:zasób ludzki "
" zarz¹dzanie kadr¹"	"  zarz¹dzaæ kadra "
" zarz¹dzanie personelem"	"  zarz¹dzaæ personel "
" zachêcanie wspó³pracowników"	"  zachêcaæ wspó³pracownik "
" zachêcanie pracowników"	"  zachêcaæ pracownik "
" mentoring"	"  mentoring  "
" bycie mentorem"	"  byt:byæ mentor "
" opieka nad pracownikami"	"  opiekaæ nad  pracownik "
" reputacja"	"  reputacja  "
"reputacja"	""
" motywowanie wspó³pracowników"	"  motywowaæ wspó³pracownik "
" motywowanie pracowników"	"  motywowaæ pracownik "
" rozumienie wskazówek niewerbalnych"	"  rozumieæ wskazówka niewerbalny "
" rozumienie jêzyka cia³a"	"  rozumieæ jêzyk cia³o "
" komunikacja niewerbalna"	"  komunikacja  niewerbalny "
" rozumienie postawy"	"  rozumieæ postaw:postawa "
" odczytywanie postaw"	"  odczytywaæ postawa:postawiæ "
" rozumienie przestrzeni osobistej"	"  rozumieæ przestrzeniæ:przestrzeñ osobisty "
" zrozumienie przestrzeni osobistej"	"  zrozumieæ przestrzeniæ:przestrzeñ osobisty "
" odczytywanie mimiki twarzy"	"  odczytywaæ mimik:mimika twarz "
" interpretowanie wyrazu twarzy"	"  interpretowaæ wyraz twarz "
" odczytywanie wyrazu twarzy"	"  odczytywaæ wyraz twarz "
" interpretowanie mimiki"	"  interpretowaæ mimik:mimika "
" odczytywanie mimiki"	"  odczytywaæ mimik:mimika "
" odczytywanie z kontaktu wzrokowego"	"  odczytywaæ z  kontakt wzrokowy "
" rozró¿nienie kontaktu wzrokowego"	"  rozró¿niæ kontakt wzrokowy "
" rozumienie gestów"	"  rozumieæ gest "
" odczytywanie dotyku"	"  odczytywaæ dotyk "
" identyfikacja dotyku"	"  identyfikacja  dotyk "
" odpowiadanie na ró¿nice kulturowe"	"  odpowiadaæ na  ró¿nica kulturowy "
" komunikacja miêdzykulturowa"	"  komunikacja  miêdzykulturowy "
" reagowanie na ró¿nice kulturowe"	"  reagowaæ na  ró¿nica kulturowy "
" odpowiadanie ró¿nicom kulturowym"	"  odpowiadaæ ró¿nica kulturowy "
" wykorzystywanie wskazówek niewerbalnych"	"  wykorzystywaæ wskazówka niewerbalny "
" wykorzystywanie mowy cia³a"	"  wykorzystywaæ mowa cia³o "
" operowanie wyrazem twarzy"	"  operowaæ wyraz twarz "
" odpowiednie u¿ywanie dotyku"	"  odpowiedni u¿ywaæ dotyk "
" przestrzeganie przestrzeni osobistej"	"  przestrzegaæ przestrzeniæ:przestrzeñ osobisty "
" respektowanie przestrzeni osobistej"	"  respektowaæ przestrzeniæ:przestrzeñ osobisty "
" u¿ywanie gestów"	"  u¿ywaæ gest "
" gestykulacja"	"  gestykulacja  "
"gestykulacja"	""
" u¿ywanie kontaktu wzrokowego"	"  u¿ywaæ kontakt wzrokowy "
" odpowiednia postawa"	"  odpowiedni postawa  "
" odpowiednia postura"	"  odpowiedni postura  "
" wypowiadanie siê"	"  wypowiadaæ siê  "
" komunikatywnoœæ"	"  komunikatywnoœæ  "
"komunikatywnoœæ"	""
" komunikatywny"	"  komunikatywny  "
"komunikatywny"	""
" wyra¿anie siê"	"  wyra¿aæ siê  "
" techniki prezentacji"	"  technik:technika prezentacja "
" prowadzenie prezentacji"	"  prowadziæ prezentacja "
" prezentowanie"	"  prezentowaæ "
"prezentowaæ"	""
" wyst¹pienia publiczne"	"  wyst¹pienie:wyst¹piæ publiczny "
" porozumiewanie siê"	"  porozumiewaæ siê  "
" zdolnoœci interpersonalne"	"  zdolnoœæ interpersonalny "
" umiejêtnoœci interpersonalne"	"  umiejêtnoœæ interpersonalny "
" nawi¹zywanie kontaktów"	"  nawi¹zywaæ kontakt "
" ³atwoœæ nawi¹zywania kontaktów"	"  ³atwoœæ  nawi¹zywaæ kontakt "
" kontakty z klientami"	"  kontakt z  klient "
" kontakty z dostawcami"	"  kontakt z  dostawca "
" kontakty z odbiorcami"	"  kontakt z  odbiorca "
" nawi¹zywanie relacji"	"  nawi¹zywaæ relacja "
" debatowanie"	"  debatowaæ "
"debatowaæ"	""
" prowadzenie debat"	"  prowadziæ debata "
" przes³uchiwanie"	"  przes³uchiwaæ "
"przes³uchiwaæ"	""
" przekonywanie"	"  przekonywaæ "
"przekonywaæ"	""
" negocjowanie"	"  negocjowaæ "
"negocjowaæ"	""
" zdolnoœci negocjacyjne"	"  zdolnoœæ negocjacyjny "
" rosyjski"	"  rosyjski  "
"rosyjski"	""
" estoñski"	"  estoñski  "
"estoñski"	""
" wietnamski"	"  wietnamski  "
"wietnamski"	""
" azerbejd¿añski"	"  azerbejd¿añski  "
"azerbejd¿añski"	""
" bu³garski"	"  bu³garski  "
"bu³garski"	""
" czeski"	"  czeski  "
"czeski"	""
" angielski"	"  angielski  "
"angielski"	""
" grecki"	"  grecki  "
"grecki:grecki:grecki"	""
"greka"	"grek:grek "
"grek:grek"	""
" kurdyjski"	"  kurdyjski  "
"kurdyjski"	""
" jawajski"	"  jawajski  "
"jawajski"	""
" galicyjski"	"  galicyjski  "
"galicyjski"	""
" s³owacki"	"  s³owacki  "
"s³owacki:s³owacki:s³owacki"	""
" niemiecki"	"  niemiecki  "
"niemiecki"	""
" hinduski"	"  hinduska:hinduska:hinduska:hinduska "
"hinduski:hinduska:hinduska:hinduska:hinduska"	""
" malajalam"	"  malajalam  "
" romski"	"  romski  "
"romski"	""
" jidysz"	"  jidysz  "
"jidysz"	""
" fiñski"	"  fiñski  "
"fiñski"	""
" holenderski"	"  holenderski  "
"holenderski"	""
" ukraiñski"	"  ukraiñski  "
"ukraiñski"	""
" litewski"	"  litewski  "
"litewski"	""
" limburgijski"	"  limburgijski  "
" serbski"	"  serbski  "
"serbski"	""
" jêzyk marathi"	"  jêzyk  marathi  "
" kazachski"	"  kazachski  "
"kazachski"	""
" wêgierski"	"  wêgierski  "
"wêgierski:wêgierski:wêgierski"	""
" bia³oruski"	"  bia³oruski  "
"bia³oruski"	""
" pend¿abski"	"  pend¿abski  "
"pend¿abski"	""
" gud¿aradzki"	"  gud¿aradzki  "
"arabski"	"arabski  "
" prowansalski"	"  prowansalski  "
"prowansalski"	""
" perski"	"  perski  "
"perski:perski:perski"	""
" portugalski"	"  portugalski  "
"portugalski"	""
" jêzyk bihari"	"  jêzyk  bihari  "
" tamilski"	"  tamilski  "
"tamilski"	""
" macedoñski"	"  macedoñski  "
"macedoñski:macedoñski:macedoñski"	""
" ³otewski"	"  ³otewski  "
"³otewski"	""
" hiszpañski"	"  hiszpañski  "
"hiszpañski:hiszpañski:hiszpañski"	""
" jêzyk telugu"	"  jêzyk  telugu  "
" rumuñski"	"  rumuñski  "
"rumuñski"	""
" turecki"	"  turecki  "
"turecki:turecki:turecki"	""
" migowy"	"  migowy  "
"migowy"	""
" duñski"	"  duñski  "
"duñski"	""
" jêzyk urdu"	"  jêzyk  urd "
" boœniacki"	"  boœniacki  "
"boœniacki"	""
" baskijski"	"  baskijski  "
"baskijski"	""
" maltañski"	"  maltañski  "
"maltañski"	""
" francuski"	"  francuski  "
"francuski"	""
" islandzki"	"  islandzki  "
"islandzki"	""
" starogrecki"	"  starogrecki  "
"starogrecki"	""
"staro¿ytny grecki"	"staro¿ytny  grecki  "
" kataloñski"	"  kataloñski  "
"kataloñski"	""
" irlandzki"	"  irlandzki  "
"irlandzki"	""
" norweski"	"  norweski  "
"norweski"	""
" walijski"	"  walijski  "
"walijski"	""
" waloñski"	"  waloñski  "
"waloñski"	""
" sardyñski"	"  sardyñski  "
"sardyñski"	""
" hebrajski"	"  hebrajski  "
"hebrajski"	""
" w³oski"	"  w³osek "
"w³oski:w³osek"	""
" gruziñski"	"  gruziñski  "
"gruziñski"	""
" jêzyk berberyjski"	"  jêzyk  berberyjski  "
" szwedzki"	"  szwedzki  "
"szwedzki"	""
" chiñski"	"  chiñski  "
"chiñski"	""
" koreañski"	"  koreañski  "
"koreañski"	""
" chorwacki"	"  chorwacki  "
"chorwacki"	""
" polski"	"  polski  "
"polski:polski:polski"	""
" bengalski"	"  bengalski  "
"bengalski"	""
" czarnogórski"	"  czarnogórski  "
"czarnogórski"	""
" s³oweñski"	"  s³oweñski  "
"s³oweñski"	""
" ³acina"	"  ³acina  "
"³acina"	""
"³aciñski"	"³aciñski  "
" albañski"	"  albañski  "
"albañski"	""
" armeñski"	"  armeñski  "
"armeñski"	""
" japoñski"	"  japoñski  "
"japoñski"	""
" rozumienie procesu samodoskonalenia"	"  rozumieæ proces samodoskonalenie:samodoskonaliæ "
" reflektowanie procesu uczenia siê"	"  reflektowaæ proces uczenie:uczyæ siê  "
" przemyœlenia na temat uczenia siê"	"  przemyœlenie:przemyœleæ na  temat  uczenie:uczyæ siê  "
" orientacja na rozwój"	"  orientacja  na  rozwój  "
" stawianie na rozwój"	"  stawiaæ na  rozwój  "
" doskonalenie umiejêtnoœci"	"  doskonaliæ umiejêtnoœæ "
" chêæ rozwoju"	"  chêciæ rozwój "
" chêæ poszerzania wiedzy"	"  chêciæ poszerzaæ wiedza "
" wyznaczanie priorytetowych zadañ edukacyjnych"	"  wyznaczaæ priorytetowy zadanie edukacyjny "
" priorytety w uczeniu siê"	"  priorytet wiek uczenie:uczyæ siê  "
" chronologia uczenia siê"	"  chronologia  uczenie:uczyæ siê  "
" priorytetyzacja uczenia siê"	"  priorytetyzacja  uczenie:uczyæ siê  "
" zarz¹dzanie procesem samodoskonalenia"	"  zarz¹dzaæ proces samodoskonalenie:samodoskonaliæ "
" zarz¹dzanie uczeniem siê"	"  zarz¹dzaæ uczenie:uczyæ siê  "
" umiejêtnoœæ uczenia siê"	"  umiejêtnoœæ  uczenie:uczyæ siê  "
" szybkie uczenie siê"	"  szybki uczyæ siê  "
" monitorowanie procesu uczenia siê"	"  monitorowaæ proces uczenie:uczyæ siê  "
" kontrolowanie procesu uczenia"	"  kontrolowaæ proces uczenie:uczyæ "
" planowanie uczenia siê"	"  planowaæ uczenie:uczyæ siê  "
" korzystanie z ró¿nych strategii uczenia siê"	"  korzystaæ z  ró¿ny strategia uczenie:uczyæ siê  "
" strategia uczenia siê"	"  strategia  uczenie:uczyæ siê  "
" badanie dowodów"	"  badan:badaæ dowód "
" analityczne myœlenie"	"  analityczny myœleæ:myœliæ "
" sprawdzanie faktów"	"  sprawdzaæ fakt "
" rozwa¿anie alternatywnych pogl¹dów"	"  rozwa¿aæ alternatywny pogl¹d:pogl¹dy "
" rozwa¿anie alternatywnych spojrzeñ"	"  rozwa¿aæ alternatywny spojrzenie "
" rozwa¿anie pogl¹dów"	"  rozwa¿aæ pogl¹d:pogl¹dy "
" rozwa¿anie spojrzeñ"	"  rozwa¿aæ spojrzenie "
" rozwa¿anie podejœæ"	"  rozwa¿aæ podejœcie "
" uzasadnianie krytyki"	"  uzasadniaæ krytyk:krytyka "
" argumentacja krytyki"	"  argumentacja  krytyk:krytyka "
" rozwa¿anie wp³ywu wyroku"	"  rozwa¿aæ wp³yw wyrok "
" rozumienie efektów os¹dzania"	"  rozumieæ efekt:efekta os¹dzaæ "
" rozumienie skutków os¹du"	"  rozumieæ skutek os¹d "
" rozumienie rezultatów wydanego s¹du"	"  rozumieæ rezultat wydaæ s¹d "
" zauwa¿anie stronniczoœci"	"  zauwa¿aæ stronniczoœæ "
" wnioskowanie"	"  wnioskowaæ "
"wnioskowanie:wnioskowaæ"	""
" logiczne myœlenie"	"  logiczny myœleæ:myœliæ "
" formu³owanie s¹dów"	"  formu³owaæ s¹d "
" formu³owanie ocen"	"  formu³owaæ ocena "
" umiejêtnoœæ oceny"	"  umiejêtnoœæ  ocena "
" ocenianie)"	"  ocenianie)  "
" wyci¹ganie wniosków"	"  wyci¹gaæ wniosek "
" poddawanie w w¹tpliwoœæ za³o¿eñ"	"  poddawaæ wiek w¹tpliwoœæ  za³o¿enie "
" pow¹tpiewanie w za³o¿enia"	"  pow¹tpiewaæ wiek za³o¿enie:za³o¿yæ "
" wyjaœnianie rozumowania"	"  wyjaœniaæ rozumowanie:rozumowaæ "
" objaœnianie argumentacji"	"  objaœniaæ argumentacja "
" identyfikacja wa¿nych tematów"	"  identyfikacja  wa¿ny temat "
" identyfikacja wa¿nych zagadnieñ"	"  identyfikacja  wa¿ny zagadnienie "
" rozpoznawanie wa¿nych zagadnieñ"	"  rozpoznawaæ wa¿ny zagadnienie "
" odnajdywanie wa¿nych zagadnieñ"	"  odnajdywaæ wa¿ny zagadnienie "
" identyfikacja kluczowych zagadnieñ"	"  identyfikacja  kluczowy zagadnienie "
" priorytetyzacja zagadnieñ"	"  priorytetyzacja  zagadnienie "
" identyfikacja wa¿nych problemów"	"  identyfikacja  wa¿ny problem "
" identyfikacja kluczowych problemów"	"  identyfikacja  kluczowy problem "
" rozpoznawanie kluczowych problemów"	"  rozpoznawaæ kluczowy problem "
" rozpoznawanie powi¹zañ"	"  rozpoznawaæ powi¹zanie "
" identyfikacja powi¹zañ"	"  identyfikacja  powi¹zanie "
" identyfikacja wzorców"	"  identyfikacja  wzorzec "
" rozpoznawanie wzorców"	"  rozpoznawaæ wzorzec "
" zadawanie kluczowych pytañ"	"  zadawaæ kluczowy pytanie "
" zadawanie wa¿nych pytañ"	"  zadawaæ wa¿ny pytanie "
" generowanienowych pomys³ów"	"  generowanienowych  pomys³ "
" kreatywnoœæ"	"  kreatywnoœæ  "
"kreatywnoœæ"	""
" nowe pomys³y"	"  nowa:nowy pomys³ "
" przewidywanie potrzeb"	"  przewidywaæ potrzeba "
" eksperymentowanie"	"  eksperymentowaæ "
"eksperymentowaæ"	""
" oryginalnoœæ"	"  oryginalnoœæ  "
"oryginalnoœæ"	""
" wy³apywanie szans"	"  wy³apywaæ szansa "
" wychwytywanie okazji"	"  wychwytywaæ okazja "
" rozpoznawanie mo¿liwoœci"	"  rozpoznawaæ mo¿liwoœæ "
" wychwytywanie szans"	"  wychwytywaæ szansa "
" wy³apywanie okazji"	"  wy³apywaæ okazja "
" wizualizacja efektu koñcowego"	"  wizualizacja  efekt koñcowy "
" wizualizacja zakoñczenia pracy"	"  wizualizacja  zakoñczenie:zakoñczyæ praca "
" wprowadzanienowych pomys³ów w ¿ycie"	"  wprowadzanienowych  pomys³ wiek ¿yto:¿yæ "
" przedsiêbiorczoœæ"	"  przedsiêbiorczoœæ  "
"przedsiêbiorczoœæ"	""
" tworzenie strategii wdra¿ania"	"  tworzyæ strategia wdra¿aæ "
" adaptacja strategii wdra¿ania"	"  adaptacja  strategia wdra¿aæ "
" oryginalnoœæ pracy"	"  oryginalnoœæ  praca "
" orginalnoœæ pracy"	"  orginalnoœæ  praca "
" analizowanie problemu"	"  analizowaæ problem "
" poznawanie kontekstu problemu"	"  poznawaæ kontekst problem "
" badanie przyczyn problemu"	"  badan:badaæ przyczyna problem "
" identyfikacja interesariuszy zwi¹zanych z problemem"	"  identyfikacja  interesariuszy  zwi¹zaæ z  problem "
" podejmowanie dzia³ania w celu rozwi¹zania problemu"	"  podejmowaæ dzia³anie:dzia³aæ wiek cel rozwi¹zanie:rozwi¹zaæ problem "
" rozwi¹zywanie problemów"	"  rozwi¹zywaæ problem "
" implementacja strategii"	"  implementacja  strategia "
" koordynowanie dzia³añ"	"  koordynowaæ dzia³anie "
" wielozadaniowoœæ"	"  wielozadaniowoœæ  "
"wielozadaniowoœæ"	""
" ocena sukcesu"	"  ocena  sukces "
" rozwi¹zywanie problemów"	"  rozwi¹zywaæ problem "
" planowanie dzia³añ"	"  planowaæ dzia³anie "
" planowanie strategiczne"	"  planowaæ strategiczny "
" opracowywanie strategii"	"  opracowywaæ strategia "
" tworzenie strategii"	"  tworzyæ strategia "
" wyznaczanie celów"	"  wyznaczaæ cel "
" stawianie celów"	"  stawiaæ cel "
" okreœlanie priorytetów dzia³añ"	"  okreœlaæ priorytet dzia³anie "
" uszeregowanie dzia³añ"	"  uszeregowaæ dzia³anie "
" priorytety dzia³añ"	"  priorytet dzia³anie "
" priorytetyzacja dzia³añ"	"  priorytetyzacja  dzia³anie "
"zarz¹dzanie czasem"	"zarz¹dzaæ czas "
" dyspozycyjnoœæ"	"  dyspozycyjnoœæ  "
"dyspozycyjnoœæ"	""
" mobilnoœæ"	"  mobilnoœæ  "
"mobilnoœæ"	""
" gotowoœæ do podró¿y"	"  gotowoœæ  do  podró¿:podró¿a "
" gotowoœæ do wyjazdów s³u¿bowych"	"  gotowoœæ  do  wyjazd s³u¿bowy "
" gotowoœæ do wyjazdu"	"  gotowoœæ  do  wyjazd "
" gotowoœæ do pracy w systemie zmianowym"	"  gotowoœæ  do  praca wiek system:systema zmianowy:zmianowa "
" gotowoœæ do pracy na zmiany"	"  gotowoœæ  do  praca na  zmiana "
" ustalanie osi czasu pracy"	"  ustalaæ osiæ:oœ czas praca "
" organizacja pracy w³asnej"	"  organizacja  praca w³asny "
" organizacja pracy"	"  organizacja  praca "
" dobra organizacja"	"  dobro:dobry organizacja  "
" postêpowanie zgodne z planem"	"  postêpowaæ zgodny z  plan "
" podejœcie metodyczne"	"  podejœæ metodyczny "
" konsekwencja"	"  konsekwencja  "
"konsekwencja"	""
" systematycznoœæ"	"  systematycznoœæ  "
"systematycznoœæ"	""
" monitorowanie postêpu"	"  monitorowaæ postêp "
" ustalanie celów"	"  ustalaæ cel "
" identyfikacja zadañ"	"  identyfikacja  zadanie "
" doœwiadczenie"	"  doœwiadczyæ "
"doœwiadczenie:doœwiadczyæ"	""
" wiedza"	"  wiedza  "
"wiedza"	""
" mile widziane"	"  mil:mila:mila:mila widzieæ "
" preferowane"	"  preferowaæ "
"preferowaæ"	""
" konieczne"	"  konieczny "
"konieczny"	""
" warunek konieczny"	"  warunek  konieczny  "
" follow ethical work practices"	"  follow  ethical  work  practices  "
" ethical work"	"  ethical  work  "
" ethical practices"	"  ethical  practices  "
" work ethics"	"  work  ethics  "
" identify social impact"	"  identify  social  impact  "
" social impact"	"  social  impact  "
" social effects"	"  social  effects  "
" reflect on own work practices"	"  reflect  on  own  work  practices  "
" good work practices"	"  good  work  practices  "
" good work methods"	"  good  work  methods  "
" carrying out duties"	"  carrying  out  duties  "
" performing duties"	"  performing  duties  "
" good methods of work"	"  good  methods  of  work  "
" good practices at work"	"  good  practices  at  work  "
" identify environmental impact"	"  identify  environmental  impact  "
" identify environmental effects"	"  identify  environmental  effects  "
" work environment effects"	"  work  environment  effects  "
" identify impact on environment"	"  identify  impact  on  environment  "
" identify impact on work environment"	"  identify  impact  on  work  environment  "
" make ethical choices"	"  make  ethical  choices  "
" ethical choices"	"  ethical  choices  "
" identify ethical issues"	"  identify  ethical  issues  "
" ethical issues"	"  ethical  issues  "
" knowing ethics"	"  knowing  ethics  "
" ethics knowledge"	"  ethics  knowledge  "
" show respect"	"  show  respect  "
" treat people fairly"	"  treat  people  fairly  "
" fair treatment"	"  fair  treatment  "
" just treatment"	"  just  treatment  "
" righteous treatment"	"  righteous  treatment  "
" equitable treatment"	"  equitable  treatment  "
" work with different viewpoints"	"  work  with  different  viewpoints  "
" respect viewpoints"	"  respect  viewpoints  "
" respect approach"	"  respect  approach  "
" openness to viewpoints"	"  openness  ten viewpoints  "
" respect perspectives"	"  respect  perspectives  "
" respect opinions"	"  respect  opinions  "
" show consideration"	"  show  consideration  "
" discretion"	"  discretion  "
" deliberation"	"  deliberation  "
" prudence"	"  prudence  "
" finesse"	"  finesse  "
" delicacy"	"  delicacy  "
" circumspection"	"  circumspection  "
" demonstrate tolerance"	"  demonstrate  tolerance  "
" tolerance"	"  tolerance  "
" broad-mindedness"	"  broad-mindedness  "
" indulgence"	"  indulgence  "
" patience"	"  patience  "
" forbearance"	"  forbearance  "
" longanimity"	"  longanimity  "
" show good manners"	"  show  good  manners  "
" manners"	"  manners  "
" personal culture"	"  personal  culture  "
" etiquette"	"  etiquette  "
" serenity"	"  serenity  "
" cheerfulness"	"  cheerfulness  "
" buoyancy"	"  buoyancy  "
" demonstrate commitment"	"  demonstrate  commitment  "
" commitment"	"  commitment  "
" involvement"	"  involvement  "
" engagement"	"  engagement  "
"engagement"	""
" work interest"	"  work  interest  "
" ambition"	"  ambition  "
" aspiration"	"  aspiration  "
" motivation"	"  motivation  "
" meet commitments"	"  meet  commitments  "
" fulfilling obligations"	"  fulfilling  obligations  "
" fulfilling duties"	"  fulfilling  duties  "
" reliability"	"  reliability  "
" punctuality"	"  punctuality  "
" meeting deadlines"	"  meeting  deadlines  "
" being on time"	"  being  on  time  "
" work on time"	"  work  on  time  "
" reliability"	"  reliability  "
" dependability"	"  dependability  "
" attend to quality"	"  attend  ten quality  "
" quality work"	"  quality  work  "
" valuable work"	"  valuable  work  "
" make an effort"	"  make  an  effort  "
" make effort"	"  make  effort  "
" hard work"	"  hard  work  "
" self-discipline"	"  self-discipline  "
" discipline"	"  discipline  "
" initiative"	"  initiative  "
" attend to detail"	"  attend  ten detail  "
" accuracy"	"  accuracy  "
" precision"	"  precision  "
" conscientiousness"	"  conscientiousness  "
" work solicitude"	"  work  solicitude  "
" work care"	"  work  care  "
" scrupulousness"	"  scrupulousness  "
" show enthusiasm"	"  show  enthusiasm  "
" enthusiasm"	"  enthusiasm  "
" dynamism"	"  dynamism  "
" zeal"	"  zeal  "
" eagerness"	"  eagerness  "
" positive attitude"	"  positive  attitude  "
" be curious"	"  be  curious  "
" curiosity"	"  curiosity  "
" showing interest"	"  showing  interest  "
" inquisitiveness"	"  inquisitiveness  "
" thirst for knowledge"	"  thirst  for  knowledge  "
" persist"	"  persist  "
" persistence"	"  persistence  "
" obstinacy"	"  obstinacy  "
" strenuousness"	"  strenuousness  "
" intransigence"	"  intransigence  "
" pugnacity"	"  pugnacity  "
" willpower"	"  willpower  "
" strong will"	"  strong  willa "
" decisiveness"	"  decisiveness  "
" resoluteness"	"  resoluteness  "
" firmness"	"  firmness  "
" courage"	"  courage  "
" work independently"	"  work  independently  "
" independence"	"  independence  "
" self-reliance"	"  self-reliance  "
" autonomy"	"  autonomy  "
" self-sufficiency"	"  self-sufficiency  "
" work efficiently"	"  work  efficiently  "
" efficiency"	"  efficiency  "
" effectiveness"	"  effectiveness  "
" efficacy"	"  efficacy  "
" productivity"	"  productivity  "
" good performance"	"  good  performance  "
" result orientation"	"  result  orientation  "
" focus on result"	"  focus  on  result  "
" fulfilment of goals"	"  fulfilment  of  goals  "
" implementation of objectives"	"  implementation  of  objectives  "
" realization of aims"	"  realization  of  aims  "
" objectives fulfilment"	"  objectives  fulfilment  "
" handle challenges"	"  handel challenges  "
" resilience"	"  resilience  "
" openness to challenges"	"  openness  ten challenges  "
" manage frustration"	"  manage  frustration  "
" capacity to deal with frustration"	"  capacity  ten deal  with  frustration  "
" manage frustration"	"  manage  frustration  "
" frustration tolerance"	"  frustration  tolerance  "
" frustration resistance"	"  frustration  resistance  "
" cope with frustration"	"  cope  with  frustration  "
" cope with pressure"	"  cope  with  pressure  "
" capacity to deal with stress"	"  capacity  ten deal  with  stress  "
" stress tolerance"	"  stress  tolerance  "
" stress resistance"	"  stress  resistance  "
" coping with stress"	"  coping  with  stress  "
" manage stress"	"  manage  stress  "
" stress tolerance"	"  stress  tolerance  "
" stress resistance"	"  stress  resistance  "
" cope with stress"	"  cope  with  stress  "
" capacity to deal with pressure"	"  capacity  ten deal  with  pressure  "
" pressure tolerance"	"  pressure  tolerance  "
" pressure resistance"	"  pressure  resistance  "
" coping with pressure"	"  coping  with  pressure  "
" manage pressure"	"  manage  pressure  "
" pressure tolerance"	"  pressure  tolerance  "
" pressure resistance"	"  pressure  resistance  "
" cope with pressure"	"  cope  with  pressure  "
" deal with uncertainty"	"  deal  with  uncertainty  "
" crisis management"	"  crisis  management  "
" critical management"	"  critical  management  "
" learn from mistakes"	"  learn  from  mistakes  "
" adapt to changes"	"  adapt  ten changes  "
" build on experience"	"  build  on  experience  "
" interact electronically"	"  interact  electronically  "
" electronic interaction"	"  electronic  interaction  "
" communicate on-line"	"  communicate  on-line  "
" on-line communication"	"  on-line  communication  "
" use mobile phone"	"  use  mobil phone  "
" using mobile"	"  using  mobil "
" using cell-phone"	"  using  cell-phone  "
" choose method of electronic interaction"	"  choose  method  of  electronic  interaction  "
" electronic interaction methods"	"  electronic  interaction  methods  "
" observe 'netiquette'"	"  observe  'netiquette'  "
" netiquette"	"  netiquette  "
" use on-line services"	"  use  on-line  services  "
" using on-line services"	"  using  on-line  services  "
" manage hardware"	"  manage  hardware  "
" use printers"	"  use  printers  "
" use pointing devices"	"  use  pointing  devices  "
" use touchpad"	"  use  touchpad  "
" use light pen"	"  use  light  pen  "
" use trackball"	"  use  trackball  "
" use image scanners"	"  use  image  scanners  "
" manage electronic information"	"  manage  electronic  information  "
" use word processing"	"  use  word  processing  "
" word processing"	"  word  processing  "
" use msword"	"  use  msword  "
" retrieve files"	"  retrieve  files  "
" detect biasin electronic information"	"  detect  biasin  electronic  information  "
" detect inaccuracy in electronic information"	"  detect  inaccuracy  inaczej electronic  information  "
" evaluate quality of electronic information"	"  evaluate  quality  of  electronic  information  "
" quality of electronic information"	"  quality  of  electronic  information  "
" use spreadsheets"	"  use  spreadsheets  "
" use msexcel"	"  use  msexcel  "
" use electronic databases"	"  use  electronic  databases  "
" use databases"	"  use  databases  "
" use msaccess"	"  use  msaccess  "
" store files"	"  store  files  "
" save files"	"  save  files  "
" cross-check electronic information"	"  cross-check  electronic  information  "
" check electronic information"	"  check  electronic  information  "
" manage software"	"  manage  software  "
" use office software"	"  use  office  software  "
" use software"	"  use  software  "
" use operating systems"	"  use  operating  systems  "
" operating systems"	"  operating  systems  "
" create electronic content"	"  create  electronic  content  "
" produce electronic images"	"  produce  electronic  images  "
" create electronic images"	"  create  electronic  images  "
" image processing"	"  image  processing  "
" image creation"	"  image  creation  "
" produce tables"	"  produce  tables  "
" create tables"	"  create  tables  "
" edit electronic content"	"  edit  electronic  content  "
" type text"	"  type  text  "
" design spreadsheets"	"  design  spreadsheets  "
" designmsexcel"	"  designmsexcel  "
" create spreadsheets"	"  create  spreadsheets  "
" create msexcel"	"  create  msexcel  "
" produce audio files"	"  produce  audio  files  "
" create audio"	"  create  audio  "
" audio creation"	"  audio  creation  "
" produce text files"	"  produce  text  files  "
" use word processors"	"  use  word  processors  "
" designmsword"	"  designmsword  "
" create msword"	"  create  msword  "
" maintain online privacy"	"  maintain  online  privacy  "
" maintain online security"	"  maintain  online  securit "
" review online privacy settings"	"  review  online  privacy  settings  "
" review online privacy"	"  review  online  privacy  "
" up-date online security measures"	"  up-date  online  securit measures  "
" up-date online security"	"  up-date  online  securit "
" install anti-virus software"	"  install  anti-virus  software  "
" install anti-virus"	"  install  anti-virus  "
" choose online security measures"	"  choose  online  securit measures  "
" choose online security"	"  choose  online  securit "
" identify online threats"	"  identify  online  threats  "
" set up passwords"	"  seta up  passwords  "
" set private settings"	"  seta private  settings  "
" set passwords"	"  seta passwords  "
" seek electronic information"	"  seek  electronic  information  "
" use internet browsers"	"  use  internet  browsers  "
" use web browser"	"  use  weba browser  "
" retrieve information from the internet"	"  retrieve  information  from  the  internet  "
" process mathematical information for work"	"  process  mathematical  information  for  work  "
" process mathematical information"	"  process  mathematical  information  "
" data analysis"	"  data  analysis  "
" data synthesis"	"  data  synthesis  "
" process data"	"  process  data  "
" process statistical information"	"  process  statistical  information  "
" process numerical information"	"  process  numerical  information  "
" organise data"	"  organise  data  "
" data organising"	"  data  organising  "
" data organization"	"  data  organization  "
" interpret data"	"  interpret  data  "
" visualise data"	"  visualise  data  "
" data interpreting"	"  data  interpreting  "
" gather data"	"  gather  data  "
" data gathering"	"  data  gathering  "
" apply mathematical concepts to work tasks"	"  apply  mathematical  concepts  ten work  tasks  "
" apply mathematics"	"  apply  mathematics  "
" apply statistics"	"  apply  statistics  "
" apply quantitative methods"	"  apply  quantitative  methods  "
" apply econometrics"	"  apply  econometrics  "
" identify mathematical problem"	"  identify  mathematical  problem  "
" apply mathematical method"	"  apply  mathematical  method  "
" apply statistical method"	"  apply  statistical  method  "
" apply numerical method"	"  apply  numerical  method  "
" apply quantitative method"	"  apply  quantitative  method  "
" apply econometric method"	"  apply  econometric  method  "
" apply mathematical model"	"  apply  mathematical  model  "
" apply statistical model"	"  apply  statistical  model  "
" apply econometric model"	"  apply  econometric  model  "
" choose relevant mathematical concepts"	"  choose  relevant  mathematical  concepts  "
" choose mathematical concept"	"  choose  mathematical  concept  "
" choose mathematical procedure"	"  choose  mathematical  procedure  "
" choose statistical procedure"	"  choose  statistical  procedure  "
" choose numerical procedure"	"  choose  numerical  procedure  "
" choose quantitative method"	"  choose  quantitative  method  "
" choose statistical method"	"  choose  statistical  method  "
" choose econometric method"	"  choose  econometric  method  "
" choose mathematical method"	"  choose  mathematical  method  "
" choose statistical model"	"  choose  statistical  model  "
" choose econometric model"	"  choose  econometric  model  "
" choose mathematical model"	"  choose  mathematical  model  "
" use mathematical tools"	"  use  mathematical  tools  "
" use mathematical equipment"	"  use  mathematical  equipment  "
" use mathematical program"	"  use  mathematical  program  "
" use statistical program"	"  use  statistical  program  "
" use econometric program"	"  use  econometric  program  "
" use measuring equipment"	"  use  measuring  equipment  "
" use calculators"	"  use  calculators  "
" use ict"	"  use  ict  "
" use information technologies"	"  use  information  technologies  "
" use communication technologies"	"  use  communication  technologies  "
" use information and communication technologies"	"  use  information  andante communication  technologies  "
" communicate mathematical work processes"	"  communicate  mathematical  work  processes  "
" interpret mathematical results"	"  interpret  mathematical  results  "
" interpret statistical process"	"  interpret  statistical  process  "
" interpret econometric process"	"  interpret  econometric  process  "
" record data"	"  record  data  "
" explain mathematical findings"	"  explain  mathematical  findings  "
" explain statistical findings"	"  explain  statistical  findings  "
" explain econometric findings"	"  explain  econometric  findings  "
" illustrate mathematical findings"	"  illustrate  mathematical  findings  "
" illustrate statistical findings"	"  illustrate  statistical  findings  "
" illustrate econometric findings"	"  illustrate  econometric  findings  "
" use appropriate mathematical language"	"  use  appropriate  mathematical  language  "
" use mathematical language"	"  use  mathematical  language  "
" use statistical language"	"  use  statistical  language  "
" carry out work-related calculations"	"  carry  out  work-related  calculations  "
" carry out calculations"	"  carry  out  calculations  "
" measuring"	"  measuring  "
" work with shape"	"  work  with  shape  "
" work with space"	"  work  with  space  "
" use numbers"	"  use  numbers  "
" implement organisational policies"	"  implement  organisational  policies  "
" loyalty"	"  loyalty  "
" support company plan"	"  support  company  plan  "
" support company mission"	"  support  company  mission  "
" monitor policy implementation"	"  monitor  polica:polica:polica implementation  "
" preserve company goodwill"	"  preserve  company  goodwill  "
" apply quality standards"	"  apply  quality  standards  "
" implement environmentally-sustainable work practices"	"  implement  environmentally-sustainable  work  practices  "
" minimise environmental risks"	"  minimise  environmental  risks  "
" preserve environmental heritage"	"  preserve  environmental  heritage  "
" assess environmental impact"	"  assess  environmental  impact  "
" reduce environmentally harmful work practices"	"  reduce  environmentally  harmful  work  practices  "
" implement equality policies"	"  implement  equality  policies  "
" consider different cultural backgrounds"	"  consider  different  cultural  backgrounds  "
" consider cultural backgrounds"	"  consider  cultural  backgrounds  "
" support gender equality"	"  support  gender  equality  "
" gender equality"	"  gender  equality  "
" foster cultural diversity"	"  foster  cultural  diversity  "
" implement safety policies"	"  implement  safety  policies  "
" store equipment safely"	"  store  equipment  safely  "
" store materials safely"	"  store  materials  safely  "
" identify risks"	"  identify  risks  "
" use safe working methods"	"  use  safe  working  methods  "
" take precautions"	"  take  precautions  "
" use correct equipment"	"  use  correct  equipment  "
" use correct tools"	"  use  correct  tools  "
" work as part of a team"	"  work  as  parta of  a  team  "
" work in a team"	"  work  inaczej a  team  "
" team work"	"  team  work  "
" accept constructive criticism"	"  accept  constructive  criticism  "
" accept criticism"	"  accept  criticism  "
" share information"	"  share  information  "
" share knowledge"	"  share  knowledge  "
" give constructive criticism"	"  give  constructive  criticism  "
" criticize"	"  criticize  "
" foster social networks"	"  foster  social  networks  "
" social networks"	"  social  networks  "
" share opinions"	"  share  opinions  "
" give opinions"	"  give  opinions  "
" collaborate on tasks"	"  collaborate  on  tasks  "
" share resources"	"  share  resources  "
" negotiate"	"  negotiate  "
" resolve conflict"	"  resolve  conflict  "
" conflict resolving"	"  conflict  resolving  "
" influence on others"	"  influenca on  others  "
" being influential"	"  being  influential  "
" persuade others"	"  persuade  others  "
" persuasiveness"	"  persuasiveness  "
" argue cases"	"  argue  cases  "
" seek consensus"	"  seek  consensus  "
" pursuit consensus"	"  pursuit  consensus  "
" seek compromise"	"  seek  compromise  "
" pursuit compromise"	"  pursuit  compromise  "
" propose options"	"  propose  options  "
" give options"	"  give  options  "
" propose possibilities"	"  propose  possibilities  "
" give possibilities"	"  give  possibilities  "
" suggest possibilities"	"  suggest  possibilities  "
" display intercultural competence"	"  display  intercultural  competence  "
" intercultural competence"	"  intercultural  competence  "
" use culturally appropriate gesture"	"  use  culturally  appropriate  gesture  "
" use culturally appropriate language"	"  use  culturally  appropriate  language  "
" respond to cultural differences"	"  respond  ten cultural  differences  "
" exercise responsibility"	"  exercise  responsibility  "
" sense responsibility"	"  sense  responsibility  "
" foster quality"	"  foster  quality  "
" preserve quality"	"  preserve  quality  "
" facilitate groups"	"  facilitate  groups  "
" create groups"	"  create  groups  "
" facilitate team"	"  facilitate  team  "
" create team"	"  create  team  "
" develop team"	"  develop  team  "
" project management"	"  project  management  "
" support colleagues"	"  support  colleagues  "
" support workers"	"  support  workers  "
" support change"	"  support  change  "
" openness to change"	"  openness  ten change  "
" decide priorities"	"  decide  priorities  "
" build relationships"	"  build  relationships  "
" build relations"	"  build  relations  "
" encourage staff"	"  encourage  staff  "
" encourage colleagues"	"  encourage  colleagues  "
" mentor"	"  mentor  "
"mentor"	""
" mentoring"	"  mentoring  "
" motivate staff"	"  motivate  staff  "
" motivate colleagues"	"  motivate  colleagues  "
" understand non-verbal cues"	"  understand  non-verbal  cues  "
" understand body-language"	"  understand  body-language  "
" understand body language"	"  understand  bod language  "
" understand postures"	"  understand  postures  "
" understand uses of personal space"	"  understand  uses  of  personal  space  "
" understand personal space"	"  understand  personal  space  "
" read facial expressions"	"  read  facial  expressions  "
" identify facial expressions"	"  identify  facial  expressions  "
" read different types of eye contact"	"  read  different  types  of  eye  contact  "
" read eye contact"	"  read  eye  contact  "
" understand gestures"	"  understand  gestures  "
" read different types of touch"	"  read  different  types  of  touch  "
" read touch"	"  read  touch  "
" respond to cultural differences"	"  respond  ten cultural  differences  "
" non-verbal communication"	"  non-verbal  communication  "
" intercultural communication"	"  intercultural  communication  "
" use non-verbal cues"	"  use  non-verbal  cues  "
" use body-language"	"  use  body-language  "
" use body language"	"  use  bod language  "
" use appropriate facial expressions"	"  use  appropriate  facial  expressions  "
" use facial expressions"	"  use  facial  expressions  "
" make appropriate use of touch"	"  make  appropriate  use  of  touch  "
" make appropriate use of personal space"	"  make  appropriate  use  of  personal  space  "
" use appropriate gestures"	"  use  appropriate  gestures  "
" make appropriate use of eye contact"	"  make  appropriate  use  of  eye  contact  "
" use appropriate posture"	"  use  appropriate  posture  "
" spoken production"	"  spoken  production  "
" presentation techniques"	"  presentation  techniques  "
" presentation"	"  presentation  "
" public speech"	"  public  speech  "
" public performance"	"  public  performance  "
" spoken interaction"	"  spoken  interaction  "
" interpersonal skills"	"  interpersonal  skills  "
" interpersonal abilities"	"  interpersonal  abilities  "
" establishing contacts"	"  establishing  contacts  "
" contact ease"	"  contact  ease  "
" contacts with clients"	"  contacts  with  clients  "
" contacts with suppliers"	"  contacts  with  suppliers  "
" contacts with customers"	"  contacts  with  customers  "
" establishing relations)"	"  establishing  relations)  "
" debating techniques"	"  debating  techniques  "
" debating"	"  debating  "
" interrogating"	"  interrogating  "
" persuading"	"  persuading  "
" negotiating"	"  negotiating  "
" russian"	"  russian  "
" estonian"	"  estonian  "
" vietnamese"	"  vietnamese  "
" azerbaijani"	"  azerbaijani  "
" bulgarian"	"  bulgarian  "
" czech"	"  czech  "
" english"	"  english  "
" greek"	"  greek  "
" kurdish"	"  kurdish  "
" javanese"	"  javanese  "
" galician"	"  galician  "
" slovak"	"  slovak  "
" german"	"  german  "
"german:german"	""
" hindi"	"  hindi  "
"hindi"	""
" malayalam"	"  malayalam  "
" romani"	"  romani  "
" yiddish"	"  yiddish  "
" finnish"	"  finnish  "
" dutch"	"  dutch  "
" ukrainian"	"  ukrainian  "
" lithuanian"	"  lithuanian  "
" limburgish"	"  limburgish  "
" serbian"	"  serbian  "
" marathi language"	"  marathi  language  "
" kazakh"	"  kazakh  "
" hungarian"	"  hungarian  "
" belarusian"	"  belarusian  "
" punjabi"	"  punjabi  "
" gujarati"	"  gujarati  "
" arabic"	"  arabica "
"arabica"	""
" occitan"	"  occitan  "
" persian"	"  persian  "
" portuguese"	"  portuguese  "
" bihari language"	"  bihari  language  "
" tamil"	"  tamil  "
"tamil:tamil"	""
" macedonian"	"  macedonian  "
" latvian"	"  latvian  "
" spanish"	"  spanish  "
" telugulanguage"	"  telugulanguage  "
" romanian"	"  romanian  "
" turkish"	"  turkish  "
" signlanguage"	"  signlanguage  "
" danish"	"  danish  "
" urdu language"	"  urd language  "
" bosnian"	"  bosnian  "
" basque"	"  basque  "
" maltese"	" maltese"
